蔡卓宜你只管给姐笑就可以了，冲鸭~	蔡卓宜	1
实话说安琪不适合进女团，矮又丑，长得像媒婆	安琪	-1
金子涵的镜头老是一闪而逝	金子涵	0
为啥林宥嘉一来就全是邓紫棋的哥哈哈哈	邓紫棋	0
敖丙，哪咤？申公豹，好傻	敖丙	0
安崎太帅了！！！！	安崎	1
虞书欣虞书欣虞书欣虞书欣虞书欣虞书欣虞书欣虞书欣虞书欣虞书欣虞书欣虞书欣虞书欣虞书欣虞书欣虞书欣	虞书欣	0
林宥嘉听邓紫棋的歌	林宥嘉	0
安琪太强了，初评级就觉得她是跳舞最好的一个	安琪	1
小北看你挺会抽烟的。	小北	0
吴亦凡边伯贤吴世勋老公啊啊啊我害怕	边伯贤	0
王承渲你最棒！！！！	王承渲	1
小葵太可爱了吧！！！	小葵	1
长公主造型失败	长公主	-1
哪吒有好经典台词呀！	哪吒	0
张总为啥不去参加歌唱类选秀呢声音条件很好啊	张总	1
熊钰清和刘耀文一起跳过舞啊啊啊啊她是IM的导师	熊钰清	0
大哥你们这帮观众这怎么投的票啊申洁这么多	申洁	0
唐刚控制住自己，你可是有大宝的人	唐刚	0
柳幕白好像程七七	柳幕	0
我放心了，哈哈哈哈哈，王承渲，徐轸轸。还有那个小姐姐，我送你们出道	徐轸轸	1
葛鑫怡葛鑫怡葛鑫怡！！！！	葛鑫怡	0
关晓彤＝老鼠屎	关晓彤	-1
王清比孔雪儿好	王清比	1
四个导师小王张总的叫真的好可爱	小王	0
woc喻言太美了吧！	喻言	1
陈昕葳金子涵加油	陈昕葳	1
不会是蕊蕊的亲爹吧	蕊蕊	0
x肖战哥哥保护我	肖战	0
蔡徐坤真的很温柔，拿手当摄像机为那个谁比划	蔡徐坤	1
孔雪儿加油！	孔雪儿	1
柳岩是艺名？姓也是	柳岩	0
哈，蔡徐坤。你真聪明	蔡徐坤	1
申冰没有名字，打的是训练生	申冰	0
李现肖战候明昊王鹤棣敖瑞鹏张云龙胡一天保护我	王鹤棣	0
蔡依林蔡依林亚洲天后	蔡依林	1
回去补魏辰直拍了拜拜	魏辰	0
孔雪儿的人品没办法get她	孔雪儿	-1
陈老师演的真好	陈老师	1
孔雪儿有点龅牙咋回事？？？？	孔雪儿	-1
吕布的兵器么？三叉戟	吕布	0
那个说王源的他是易烊千玺好吗？	易烊千玺	0
王清是单眼皮的雪莉吧！	王清	0
陈珏，陈珏，陈珏	陈珏	0
坤哥不会害羞了吧😂😂😂	坤哥	0
我也挺喜欢杨迪的	杨迪	1
许佳琪加油啊	许佳琪	1
牛头梗也可以跳得很好啊，对吧孙红雷?	孙红雷	0
菜徐坤眼睛太对了	菜徐坤	0
金子涵金子涵，金子涵金子涵。冲啊	金子涵	1
孔雪儿安静也叫不屑？？？求求键盘侠长眼睛和脑子	孔雪儿	-1
看不懂的移步隔壁oxlxs看看陈立农前辈的初评级，别整天就蔡徐坤太宽，张艺兴他们不也给陈立农了个a	张艺兴	0
孔雪儿龅牙吗	孔雪儿	-1
哪吒头上起了兩个包	哪吒	0
刘令姿跳舞真的漂亮	刘令姿	1
这是我目前最喜欢的3A，加上王总四个A，出除孙雪儿的A不喜欢，其他都好喜欢加油！	王总	1
王承渲更像C位	王承渲	0
听说配哪吒的哑了一个月!	哪吒	0
陆柯燃啊啊啊啊	陆柯燃	1
虞书欣虞书欣虞书欣虞书欣虞书欣虞书欣虞书欣虞书欣虞书欣虞书欣虞书欣虞书欣虞书欣虞书欣虞书欣虞书欣	虞书欣	0
其实我觉得那个申洁比她那几个姐姐稍微好一点	申洁	1
魏辰魏辰魏辰魏辰魏辰————！！！！！	魏辰魏辰	0
张总像周冬雨的那只鸭子	张总	0
这组谁不比孔雪儿好？？？？？	孔雪儿	-1
丑逼安琪滚丑逼安琪滚丑逼安琪滚丑逼安琪滚丑逼安琪滚丑逼安琪滚丑逼安琪滚丑逼安琪滚丑逼安琪滚	安琪	-1
陈品瑄排名好后呀，才第69名	陈品瑄	0
啊啊啊啊魏辰魏辰魏辰魏辰	魏辰	1
蕊蕊不是那孩子别刷了行不行	蕊蕊	0
最爱的三个歌手都来了，深深，花花，毛毛	毛毛	1
天生爱豆孔雪儿！！	孔雪儿	1
小葵的小奶音	小葵	0
pickpick魏辰小姐姐吧，唱跳都好怎么排名那么低也没箭头	魏辰	0
看完这个，再看孔雪儿，什么玩意	孔雪儿	-1
人家感情史的年份都比你认识曾小贤的日子多两倍了	曾小贤	0
第三季没有如果那一集里是曾小贤的女友，其他都是子乔前女友	曾小贤	0
牧尘情敌又来了	牧尘	0
许佳琪许佳琪许佳琪许佳琪许佳琪许佳琪许佳琪许佳琪许佳琪许佳琪许佳琪许佳琪许佳琪许佳琪许佳琪许佳琪	许佳琪	0
邓紫棋的歌林宥嘉不尴尬吗	邓紫棋	0
安琪太帅辣！！！！！	安琪	1
为什么把王俊凯打成这样	王俊凯	0
一看就是买的票，王承渲明显更棒，申什么那个还给自己加戏	王承渲	1
蔡卓宜蔡卓宜蔡卓宜蔡卓宜蔡卓宜蔡卓宜加油！！！	蔡卓宜	1
蔡卓宜加油吖蔡卓宜加油吖蔡卓宜加油吖	蔡卓宜	1
周深你也太可爱了吧	周深	1
徐紫茵啊啊啊啊冲啊	徐紫茵	1
许佳琪跳的比较利落干净吧	许佳琪	1
虞书欣麻麻爱你。💜虞书欣冲冲冲！！！虞书欣麻麻爱你。💜虞书欣冲冲冲！！！虞书欣麻麻爱你。💜虞书欣冲冲冲！！！虞书欣麻麻爱你。💜	虞书欣	1
孔雪儿给我出道！！！！	孔雪儿	1
许杨玉琢好甜啊	许杨玉琢	1
瞪什么瞪李玄通大眼睛	李玄通	0
这些黑子在现实生活是不是真没男人喜欢不然为啥对一个女生这么恶毒	黑子	-1
安崎太可爱了啊啊啊啊wsl	安崎	1
制作支持周迅	周迅	1
风语咒，哪吒魔童降世都看了，就差最后的魁拔了！等你	风语咒	0
实力vocal王思予实力vocal王思予实力vocal王思予实力vocal王思予，豆包冲啊！！！！	王思予	1
虞书欣虞书欣虞书欣虞书欣虞书欣虞书欣虞书欣虞书欣虞书欣	虞书欣	0
修女是孙千吗？	孙千	0
安崎太暖了我的天，实力也超强	安崎	1
蔡卓妍绝了，她的颜让我忘记她的实力	蔡卓妍	1
王欣宇好油腻啊…………	王欣宇	-1
刘令姿给我冲啊啊啊啊啊啊	刘令姿	1
安崎太🉑️了	安崎	1
文哲咋那么像颖儿捏？	文哲咋	0
七穗参加过《这样唱好美》陈立农是里面的评委	七穗	0
洛璃；雨女无瓜	洛璃	0
唐刚控制住自己，你可是有大宝的人	大宝	0
包贝尔害人不浅	包贝尔	-1
真的不喜欢孔雪儿，老板脸，即便突然洗白也不喜欢	孔雪儿	-1
确实。觉得郑玉歆最好	郑玉歆	1
许佳琪不就是周洁琼闺蜜吗	周洁琼	0
搞了半天，哪吒这样来的	哪吒	0
先别想媳妇了，牧尘先照顾好自己吧	牧尘	0
等等？赵志伟也在？	赵志伟	0
黄晓明看到没	黄晓明	0
胡子哥叫黄觉	黄觉	0
如果你一直往后看的话，汉斯就是个人渣。	汉斯	-1
艾莎和安娜你，我真的很想见那个安娜，有病。	安娜	0
华晨宇，不容置疑哭了！	华晨宇	1
太二逼了王源	王源	-1
好开心，我的喻言宝贝从31变成了21，而可寅小仙女从55变成了15🥰🥰	喻言	1
林宥嘉是台独分子	林宥嘉	-1
傅如乔哈哈哈哈哈有点可爱	傅如乔	1
张总有点像王源	张总	0
林小宅是个抄袭怪！！！！Lisa居然没看出来那是自家姐妹的舞	林小宅	-1
懂音乐的人都知道袁娅维的技巧是没有对手的，不懂的人只管好不好听	袁娅维	0
安崎，安崎妈呀，我太喜欢，太喜欢，太喜欢了。	安崎	1
蔡徐坤，你个梗王	蔡徐坤	0
关晓彤这个瓜婆娘被鹿晗操傻了吧傻逼一样	关晓彤	-1
蔡徐坤真相了！！！	蔡徐坤	0
牧尘眼睛还没好	牧尘	0
安崎比孔雪儿强多了	孔雪儿	-1
u1s1,魏莱挺好看的	魏莱	1
陈品瑄冲冲冲太突出了	陈品瑄	1
蔡卓宜出道啊！	蔡卓宜	1
本来还挺喜欢Ella老师的，但是这么说张溪杨蕊菡张楚寒就有一点过分了吧毕竟你在101还是很喜欢她们的	杨蕊菡	0
这部剧什么时候郭德纲赵本山成龙周润发刘德华他们出来，就为了看他们。。。。。。。。。。。。。。。。。	周润发	0
喜欢孔雪儿的祝你们的男朋友也被人抢哦孔雪儿抢男人第一名	孔雪儿	-1
安琪有点用力过猛	安琪	-1
戴燕妮太甜了	戴燕妮	1
戴燕妮谢可寅刘雨昕黄小芸金子涵刘亚楠王承渲安崎赵小棠	黄小芸	0
陈珏冲冲冲！！！	陈珏	1
我好歹以前电竞女李青我怕谁？	李青	0
突现上官喜爱的侧脸。真就夹缝里寻找😂	上官喜爱	0
你保护世界，我保护你！小北加油💪	小北	1
曾小贤的灰夏利	曾小贤	0
确实好多地方在致敬周星驰	周星驰	1
林宥嘉听邓紫棋的歌。。	邓紫棋	0
坤哥说对了哈哈哈哈	坤哥	0
杰克船长还在断头台上呢	杰克船长	0
王承渲，加油	王承渲	1
留个名，朱小宝	朱小宝	0
谢可寅和豆豆给人的感觉好像	谢可寅	0
喜欢袁泉的请举手	袁泉	1
披金斩棘不畏涵霜金子涵金子涵金子涵金子涵冲鸭披金斩棘不畏涵霜金子涵金子涵金子涵金子涵冲鸭！	金子涵	1
王清！！！！陈珏！！！	王清	0
文哲可惜了长得好看实力也不错	文哲	1
留个名，晓晓	晓晓	0
曾可妮也太好看了吧	曾可妮	1
金子涵真的好像周子瑜，长相性格都像	周子瑜	0
范闲死了五号别说了	范闲	0
哪吒，你太好了	哪吒	1
王源演的牧尘真的太棒了	王源	1
王思予王思予王思予王思予王思予王思予王思予王思予	王思予	0
没有魏莱的未来不是我想要的未来	魏莱	1
孔雪儿不能是对自己不满意、	孔雪儿	0
其他三个跟坤battle啊就算你是导师你也不能这么说申洁她有亮点有那个亮点你懂嘛你不了解在场每一个人的看法	申洁	0
你才是来搞笑的，看你这昵称，肖战的粉丝都好烦啊！	肖战	-1
林小宅冲冲冲	林小宅	1
欢迎密码，你用心，你敏敏婆，魔攻，神龙龙大哪吒，小哪吒，刚生出来的小哪吒，奥比太乙真人。	哪吒	0
OMG孔雪儿真的不是我pick的颜	omg	0
该领盒饭了哪吒	哪吒	0
许杨玉琢说了要solo又不让她去，为什么匠心就可以有两个人？	许杨玉琢	0
刘雨欣我真的爱了	刘雨欣	1
袁泉真的是实力＋气质	袁泉	1
这样一对比，孔雪儿是个什么东西竟然能拿A	孔雪儿	-1
这个不比那个孔雪儿好？？？？	孔雪儿	-1
我觉得最后来一个小北和陈念的结婚照更好，让结局更加完美	小北	0
曾志伟儿子作品	曾志伟	0
加油漂亮姐姐蔡卓宜！	蔡卓宜	1
许佳琪我i了	许佳琪	1
许杨玉琢？？	许杨玉琢	0
你在翻也是辣鸡申洁	申洁	-1
郭麒麟真是个二，看起来就是个败家子！	郭麒麟	-1
如果敖丙赢了，他就是正义的龙族得到了解放，哪吒赢了他就是正义的，拯救了在场的人	哪吒	0
我特别喜欢华晨宇	华晨宇	1
孔雪儿太棒了	孔雪儿	1
戴燕妮素颜明显整容了，太普通了	戴燕妮	-1
申公豹不是姜子牙师弟吗？怎么成太乙真人师弟了？？？？！！	姜子牙	0
他不是庆帝私生子吗？老范背锅侠？	背锅侠	0
这个投票看不太懂，喜欢徐紫茵，超棒！	徐紫茵	1
魏辰魏辰魏辰魏辰魏辰魏辰魏辰魏辰魏辰！	魏辰	0
王青像汤唯和钟丽缇的结合	王青	0
索隆的内心是崩溃的	索隆	0
魏辰小姐姐出道吧！	魏辰	0
王思予给爷出道！！	王思予	1
不是请不到梁博是他没资格	梁博	0
许佳琪许佳琪许佳琪许佳琪许佳琪许佳琪许佳琪许佳琪许佳琪许佳琪	许佳琪	0
沈苍生还挺帅的	沈苍生	1
刘令姿出道吧	刘令姿	1
刘雨昕为啥这么可爱！	刘雨昕	1
刘雨昕如果你是男的我会喜欢你的	刘雨昕	1
风语咒，哪吒魔童降世都看了，就差最后的魁拔了！等你	哪吒魔童降世	0
王子叫汉斯王子	汉斯	0
王源演得真好	王源	1
莎莎太可爱了~	莎莎	1
孔雪儿还长的一般？？？我的妈，请让我也这么一般，谢谢。夸别人好看那么难吗？？	孔雪儿	1
陈萍萍是哪位	陈萍萍	0
刘令姿刘令姿刘令姿❤️❤️❤️	刘令姿	1
刘令姿刘令姿刘令姿刘令姿刘令姿刘令姿刘令姿刘令姿	刘令姿	0
杨迪很讨人喜欢，但不讨喷子喜欢	杨迪	1
杨迪就一小人痒。	杨迪	-1
孔雪儿是真的不要脸	孔雪儿	-1
前面说刘昊然的刘昊然在哪？你给我圈出来看看	刘昊然	0
王承渲王承渲	王承渲	0
不喜欢王承渲	王承渲	-1
我怎么感觉林小宅说话都说不清楚	林小宅	0
安崎太棒了！！！	安崎	1
喻言加油！！！A爆了啊！！！！！	喻言	1
姜子牙你给我等着。	姜子牙	0
她哪来的资格和毛毛相提并论	毛毛	0
王牌对王牌第5季:沈腾贾玲模仿甜蜜蜜坐垮自行车华晨宇杨迪还原年画娃娃	杨迪	0
做作女。虞书欣	虞书欣	-1
哈哈哈魏辰麦都跳掉了	魏辰麦	0
彭于晏不错，这眼神	彭于晏	1
范丞丞保护我	范丞丞	0
金子涵太美啦绝了	金子涵	1
安崎我爱你，加油你是最棒的	安崎	1
觉得申洁也很好，王承渲强捧之耻	王承渲	-1
莎莎眼里透着无奈	莎莎	0
金子涵！我来了	金子涵	1
华晨宇厉害👍！！	华晨宇	1
许佳琪不就是周洁琼闺蜜吗	许佳琪	0
明明是张一山	张一山	0
李现肖战候明昊王鹤棣敖瑞鹏张云龙胡一天保护我	张云龙	0
我还是喜欢张总哎	张总	1
虞书欣能再作一点么	虞书欣	-1
又一个陈立农	陈立农	0
华晨宇华晨宇华晨宇华晨宇	华晨宇	0
许杨玉琢太可爱了吧！	许杨玉琢	1
那些花啊，沈腾夏洛特烦恼	夏洛特烦恼	0
曾可妮好漂亮	曾可妮	1
我看到喻言对舞台这么认真我快哭了	喻言	1
在林宥嘉面前唱邓紫棋的歌？害	林宥嘉	0
好像听到申清说了一声“操”	申清	-1
邓紫棋可能暑假继续录新说唱	邓紫棋	0
戴燕妮小姐姐冲冲冲！	戴燕妮	1
我觉得没必要因为申冰去讨厌申洁，因为申洁之前也说过，如果自己做的不好，就让渲当，主要还是申冰的问题	申洁	0
王俊凯你骑车好帅	王俊凯	1
林小宅太适合这种酷风格	林小宅	1
孙红雷的牛头梗你抢不走的，做自己吧	孙红雷	0
陆柯燃陆柯燃陆柯燃陆柯燃	陆柯燃	0
周冬雨，易烊千玺演技好好。	周冬雨	1
哪吒家有。他是孙公公。	哪吒	0
我看好陈品瑄我觉得会出道	陈品瑄	1
才发现戴燕妮声音好甜啊	戴燕妮	1
防弹少年团的血汗泪？动作一模一样	防弹少年团	0
大林是不是因为范思哲这牌子的梗才选的他	范思哲	0
王思予王思予！！！	王思予	0
虞书欣太作了	虞书欣	-1
虞书欣呢???	虞书欣	0
华晨宇💕💕！！！	华晨宇	1
华晨宇。乱吼乱叫的	华晨宇	0
林小宅很好看呀	林小宅	1
王一博保护我	王一博	0
徐紫茵啊啊啊啊啊啊啊，爱了爱了	徐紫茵	1
刘令姿刘令姿刘令姿刘令姿刘令姿刘令姿	刘令姿	0
许佳琪，许佳琪，许佳琪	许佳琪	0
太牛逼了哪吒	哪吒	1
我爱蔡徐坤蔡徐坤蔡徐坤蔡徐坤蔡徐坤✨✨✨✨✨✨✨✨✨	蔡徐坤	1
谢可寅注意形象哈哈哈哈	谢可寅	1
第三季没有如果那一集里是曾小贤的女友，其他都是子乔前女友	子乔	0
金子涵金子涵金子涵金子涵冲冲冲	金子涵	1
那不是易烊千玺吗	易烊千玺	0
葛鑫怡冲冲冲	葛鑫怡	1
林小宅真的可以诶	林小宅	1
秦牛正威哭什么确实该骂啊	秦牛正威	-1
毛毛很优秀但不适合比赛	毛毛	1
风语咒，哪吒魔童降世都看了，就差最后的魁拔了！等你	魁拔	0
！安崎！实力全能ACE🍒爆炸小甜心❗️舞台小钢炮🌶️重庆辣妹！安崎宝贝冲！来pick安崎吧！！！	安崎	1
杨迪太聪明啦😄路转粉啦啦啦啦啦啦啦啦噜啦啦噜啦啦	杨迪	1
还是更喜欢许佳琪	许佳琪	1
李靖甄子丹配音	李靖	0
安娜太自私了吧	安娜	-1
肖战保护我！	肖战	0
申冰真让人恶心	申冰	-1
金子涵孔雪儿加油！！！	金子涵	1
申冰的声音真的讨厌	申冰	-1
安崎给我冲！！！	安崎	1
黄小芸啊冲冲冲	黄小芸	1
吕子乔穿的是棒球衣，手套是足球守门员的，头盔是摩托车的	吕子乔	0
许佳琪是清妃吗	许佳琪	0
喻言眼神杀我	喻言	0
真的不知道你们喷什么，真是，你行你上啊，孔雪儿抛开别的讲，她实力也很强很好吧	孔雪儿	1
哪吒，小时候好可爱😍	哪吒	1
徐轸轸徐轸轸徐轸轸	徐轸轸	0
心疼我的李沁	李沁	1
戴燕妮真的CL都拿不到镜头绝了	cl	0
文哲为啥扎头发呀！唉！散发好些	文哲为	0
孔雪儿!!!!!	孔雪儿	0
一首王俊凯的醒着送给血灵子	血灵子	0
许佳琪奥利给，棒棒棒	许佳琪	1
林宥嘉在现场听《我的秘密》，哈哈	我的秘密	0
说王源的给我出去这是王俊凯	王源	0
喻言冲第一名！！	喻言	1
许佳琪冲啊！！！	许佳琪	1
所以王思予和魏辰真的太难了，而且她两真的很优秀，但是没媒体资源	魏辰	0
安崎确确实实	安崎	0
安崎啊啊啊啊啊	安崎	1
小葵三岁不能再多了	小葵	0
什么情况，明明徐紫茵才是真实力	徐紫茵	1
孔雪儿五官可以就是脸型有点尖瑞	孔雪儿	0
现在的陈念有说不出来的滋味	陈念	0
孔雪儿他不配	孔雪儿	-1
刘长健机长你太厉害了👍	刘长健	1
林宥嘉你不尴尬吗？？？？？？	林宥嘉	-1
黄欣苑镜头太少了，表白金子涵啊啊啊	黄欣苑	-1
？？？？？！！！！认真的？！就给我整这？！渲再差也比申洁好吧？莫名其妙	申洁	-1
四字弟弟好吧，怎么变王俊凯了	王俊凯	0
张总像周冬雨的那只鸭子	周冬雨	0
这句切腹居然是个伏笔，看来索隆家乡是和之国	索隆	0
葛鑫怡葛鑫怡葛鑫怡！！！！	葛鑫怡	0
何美延怎么这么恶心	何美延	-1
蔡徐坤这孩子也太实诚了😂	蔡徐坤	1
许佳琪快本三个字真是印象深刻啊呕	快本	1
金子涵都没有镜头	金子涵	0
A班的都是实力担当除了孔雪儿，太作了，不喜欢	孔雪儿	-1
蔡卓宜没有去过音乐。	蔡卓宜	0
金子涵有点AOA雪炫是感觉	雪炫	0
好恶心的杨迪，真心讨厌	杨迪	-1
黄晓明我，对不起。	黄晓明	0
杨迪真的能听见，哈哈哈哈	杨迪	0
申公豹好坏呀	申公豹	-1
蔡卓宜给老子爬离过婚的有什么资格加入女团	蔡卓宜	-1
这几个哪个不比孔雪儿强	孔雪儿	-1
张新成是谁，干啥的。。。。。。。。。。。。。。。。。。。。。。。。。。。。。。。。。。。。。。。。。。。。。。。。。。。	张新成	0
莫寒的嘴。整过?'''	莫寒	-1
王源演的牧尘真的太棒了	牧尘	1
杨迪b话多的很	杨迪	-1
听说毛毛被奇袭？	毛毛	0
没错啦小王很独特真的个人意见	小王	1
一首王俊凯的醒着送给血灵子	王俊凯	0
孔雪儿天仙配	孔雪儿	1
申洁就还行啊，那个申冰一直作妖，吐了	申洁	1
啥时候林小宅啊就等着她了	林小宅	1
王源。。。要不要那么像。。。	王源	0
王承渲你很棒！我很喜欢你	王承渲	1
然后变成哪吒拯救了敖丙和龙族吗	敖丙	0
哪吒很厉害的，还有新皮肤	哪吒	1
王琳凯保护我，蔡徐坤保护我，陈立农保护我。	王琳凯	0
王牌对王牌第5季:沈腾贾玲模仿甜蜜蜜坐垮自行车华晨宇杨迪还原年画娃娃	王牌对王牌第5季	0
花花（华晨宇）唱过！！！！！♥♥♥	花花	1
许佳琪这女的长在我审美上了	许佳琪	1
是金子涵他是乐华娱乐的	金子涵	0
太乙真人：嘿嘿，没想到吧，我又出逃出来了。哪吒：我崩溃了呀，我彻底崩溃了呀，崩上天了我。	太乙真人	0
戴燕妮戴燕妮戴燕妮	戴燕妮	0
这哪吒和敖丙就是鸣人和佐助的影子，剧情和中心思想也来自火影忍者	火影忍者	0
许杨玉琢冲冲冲！	许杨玉琢	1
喻言啊啊啊啊啊啊啊啊!!	喻言	1
哪吒的小姐姐配音员为了配出烟嗓，失声了三天，唉，不容易啊	哪吒	0
王牌对王牌第5季:沈腾贾玲模仿甜蜜蜜坐垮自行车华晨宇杨迪还原年画娃娃	贾玲	0
上官喜爱好丑	上官喜爱	-1
我有点迷，前几期弹幕不都还在黑孔雪儿吗	孔雪儿	0
我觉得没必要因为申冰去讨厌申洁，因为申洁之前也说过，如果自己做的不好，就让渲当，主要还是申冰的问题	申冰	-1
许佳琪我可以！！！	许佳琪	1
葛鑫怡，出道	葛鑫怡	1
申冰再多说一句我就吐死了	申冰	-1
哈哈哈，牧尘你太冷漠了	牧尘	0
花花周深都是宝藏男孩	周深	1
小王有点像汤唯，有点神似	汤唯	0
左卓左卓左卓冲啊	左卓	1
戴燕妮太好看了吧	戴燕妮	1
刘令姿鲨我！！	刘令姿	1
孔雪儿滚吧，骂蔡徐坤	蔡徐坤	0
不要再黑王承渲了，爱奇艺恶意剪辑关她什么事，并且他还那么努力	王承渲	0
这个哪吒还是真的有点那个就是不听话的，他还拿那个戴眼镜的那个保温箱了一下。	哪吒	0
谁知道李沁是几号位	李沁	0
还说没有私信，申洁跳的一点也不好	申洁	-1
太喜欢安崎了	安崎	1
喜欢戴燕妮期待！	戴燕妮	1
虞书欣可以去司马?真的好作Y呀！	虞书欣	-1
真的是欠周冬雨和易洋千玺一张电影票	易洋	1
莎莎妈妈爱你	莎莎	1
陈珏陈珏陈珏！！！！	陈珏	0
可叔叔好丑啊，不配我家哪吒	哪吒	0
戴燕妮谢可寅刘雨昕黄小芸金子涵刘亚楠王承渲安崎赵小棠	金子涵	0
好吧我懂了，连孔雪儿也敌不过🐮姐	孔雪儿	0
喻言太帅了啊啊啊啊啊啊啊啊	喻言	1
房东像范冰冰	范冰冰	0
金子涵成绩公布的时候感觉怯生生地看孔雪儿	孔雪儿	0
孔雪儿这龅牙	孔雪儿	-1
徐佳莹知道套路了改歌大家都喜欢	徐佳莹	0
张伟你是个人才。还你的生日x s w l	张伟	0
安崎不红天理难容	安崎	1
杨迪能听见别人说话	杨迪	0
张伟:呦呵，不用洗碗了	张伟	0
蔡徐坤真的！让我改观了！	蔡徐坤	1
黄小芸冲冲冲啊啊啊啊啊	黄小芸	1
申洁都有点不好意思了	申洁	0
对，离过婚又怎样，你们没资格管别人做什么事，你可以不看，但你不能黑别人，反正蔡卓宜我爱了	蔡卓宜	1
乔楚生！乔楚生！看唇形是乔楚生！	乔楚生	0
孔雪儿你黑我坤，现在又这么嘚瑟你的良心呢？	孔雪儿	-1
太夸张了吧，哪吒	哪吒	0
恶心吧啦的申公豹	申公豹	-1
申冰也是无语	申冰	-1
麻烦给金子涵一点镜头吧谢谢qmq	金子涵	0
是不是有哪吒2？	哪吒	0
刘令芝之前妆容有点像孟美岐	孟美岐	0
张伟哪来的自信	张伟	0
戴燕妮戴燕妮戴燕妮戴燕妮戴燕妮戴燕妮戴燕妮戴燕妮冲	戴燕妮	1
喻言出道吧拜托了呜呜呜	喻言	1
徐紫茵难道不比czy好？不知道这观众怎么看的	徐紫茵	1
牧尘，快，有人抢你媳妇	牧尘	0
最惨a班戴燕妮	戴燕妮	0
林小宅能不能把手伸直，混子一个	林小宅	-1
这部剧什么时候郭德纲赵本山成龙周润发刘德华他们出来，就为了看他们。。。。。。。。。。。。。。。。。	成龙	0
单凭跳舞赵小棠差么？	赵小棠	0
徐紫茵在和声啊虽然不突出但是是最不可少的那个啊	徐紫茵	1
赶紧淘汰华晨宇	华晨宇	-1
申洁不是退赛了吗	申洁	0
啊啊啊啊啊啊啊徐紫茵爱了爱了	徐紫茵	1
那个说王源的他是易烊千玺好吗？	王源	0
金子涵金子涵，啊啊啊！！！！	金子涵	1
许杨玉琢！！！	许杨玉琢	0
说实话我真的觉得蔡卓宜唱的很一般还没我好听	蔡卓宜	-1
申公豹是个结巴吗	申公豹	0
戴燕妮镜头感很好	戴燕妮	1
老张哥你在看吗	老张哥	0
文哲长得像金所炫	文哲长	0
孔雪儿脸型怪怪的	孔雪儿	-1
不牧尘你不会想喝的	牧尘	0
戴燕妮好看有实力	戴燕妮	1
好可爱呀哪吒	哪吒	1
陈念，我保护你	陈念	0
小白还是在意芊儿的	芊儿	0
哪吒是世界的最坏的人	哪吒	-1
眼睛笑起来真的像姜潮	姜潮	0
魏辰魏辰魏辰魏辰魏辰魏辰魏辰魏辰魏辰	魏辰魏辰	0
你一票，我一票，佳琪明天就出道	你一	0
留个名易烊千玺	易烊千玺	0
柳慕白摆臭脸给谁看啊，wk，就看不惯他那副垃圾样	柳慕白	-1
金子涵孔雪儿都超好的	孔雪儿	1
我从第七期过来的，毛毛被黄赶走了。。。。哈哈哈	毛毛	0
陈道明程凤台	程凤台	0
想磕牧尘和沈师兄的cp	沈师兄	0
所有人里面最讨厌冰清玉洁，秦牛正威，蔡卓宜，黄一鸣，莫寒，尤其蔡卓宜音准不会舞蹈也不会，不知道来干嘛	秦牛正威	-1
蔡徐坤蔡徐坤蔡徐坤蔡徐坤蔡徐坤蔡徐坤蔡徐坤蔡徐坤蔡徐坤蔡徐坤蔡徐坤蔡徐坤蔡徐坤蔡徐坤蔡徐坤蔡徐坤蔡徐坤蔡徐坤蔡徐坤蔡徐坤	蔡徐坤	0
易烊千玺演技棒棒哒	易烊千玺	1
这哪吒和敖丙就是鸣人和佐助的影子，剧情和中心思想也来自火影忍者	哪吒	0
金子涵人都没拍清楚就转镜头	金子涵	0
赵小棠第三了	赵小棠	0
张新成加油，爱你	张新成	1
我想投票给解解邓紫棋……	邓紫棋	1
金子涵冲鸭！！！	金子涵	1
前面那个说秀儿的，sxwl	秀儿	0
书里郑易是喜欢陈念的	陈念	0
林俊杰来了节目悬念还咋弄	林俊杰	1
许佳琪腿好长	许佳琪	1
许佳琪出道吧	许佳琪	1
喻言什么时候上啊	喻言	0
张耀，李师傅！！！！超帅的	李师傅	1
魏辰啊出道吧！！大家看看魏辰妹妹	魏辰	1
小北快来，阿念被欺负了	小北	0
林晓霞快给我的大虞海棠投票！！！	林晓霞快	0
谢可寅冲啊！！	谢可寅	1
许佳琪好温柔！	许佳琪	1
薛之谦薛之谦薛之谦薛之谦薛之谦	薛之谦	0
魏辰魏辰魏辰魏辰魏辰魏辰魏辰魏辰魏辰	魏辰魏辰	0
孔雪儿我来了	孔雪儿	1
蔡卓宜好好看呀！！	蔡卓宜	1
我看了一个视频，还说申洁是小三，不喜勿喷	申洁	-1
这剪辑就是为了让孔雪儿拿首A吗？？？？？？？	孔雪儿	0
许佳琪！！！！	许佳琪	0
魏辰魏辰魏辰魏辰魏辰魏辰魏辰	魏辰	0
我听到的台下都是蔡徐坤，蔡徐坤，蔡徐坤，蔡徐坤，蔡徐坤，蔡徐坤，蔡徐坤，蔡徐坤，蔡徐坤，蔡徐坤。	蔡徐坤	0
王清长得很耐看	王清长	1
金子涵，冲冲冲	金子涵	1
蔡卓宜不喜欢	蔡卓宜	-1
刘雨昕刘雨昕刘雨昕	刘雨昕	0
申洁是个啥玩意？？？？？？？？？？？？？？？？？？？？？？？？？？？？？？？？？？？？？？？？？？？	申洁	-1
哪吒变身比他更帅	哪吒	1
这是为了帮牧尘设计的吧，沈师兄有心了	牧尘	0
蔡徐坤我爱你我爱你啊啊！！！！！	我爱你	1
乃万呢？？？？虞书欣呢？？？？？完了？	虞书欣	0
许佳琪帅炸了！！	许佳琪	1
王欣宇说话的时候可以不要摇头晃脑的吗，看起来真的……	王欣宇	0
孔雪儿！！！	孔雪儿	0
不是申C位吗怎么中间一直是王承渲	王承渲	0
韩雪挺优秀但为什么就是喜欢不起来呢	韩雪	0
白幼宁就是作死，还有脸说是玩笑，有这么大的玩笑嘛	白幼宁	-1
为啥我对王欣宇真的无感	王欣宇	0
杨迪应该调耳机	杨迪	0
熊钰清和刘耀文一起跳过舞啊啊啊啊她是IM的导师	im	0
许佳琪我可以	许佳琪	1
谢可寅太可爱了哈哈哈哈	谢可寅	1
李小冉，太美了！	李小冉	1
甄子丹的声音	甄子丹	0
他不是庆帝私生子吗？老范背锅侠？	庆帝	0
这是易烊千玺	易烊千玺	0
书里郑易是喜欢陈念的	郑易	0
我爱蔡徐坤蔡徐坤蔡徐坤蔡徐坤蔡徐坤✨✨✨✨✨✨✨✨✨	蔡徐坤	1
王承渲冲冲冲	王承渲	1
王承渲比申杰好	申杰	-1
哪吒你熬夜了吗？黑眼圈？	哪吒	0
e魏莱被陈念手误给杀了，小北背的黑锅	陈念	0
金子涵啊啊啊	金子涵	1
刘令姿太可了	刘令姿	1
蔡徐坤你个垃圾走开	蔡徐坤	-1
看看张天爱吧	张天爱	0
小葵，瞎说什么大实话	小葵	0
假如把杨迪换成肖战，肖战答对，他都听得见，肖战以后都别来了，玩赖的玩意	肖战	-1
艾玛给黑山老妖一样	艾玛	0
黑子破坏心情其他啥也不会	黑子	-1
只是说实话而已并不是王承渲粉丝她本来就适合当C位	王承渲	1
我听到的台下都是蔡徐坤，蔡徐坤，蔡徐坤，蔡徐坤，蔡徐坤，蔡徐坤，蔡徐坤，蔡徐坤，蔡徐坤，蔡徐坤。	蔡徐坤	0
还好莎莎没有被抓住眼球，不然要出大事情	莎莎	0
好在陈念还有小北，她们是真诚的	小北	1
杨迪也带不动呀	杨迪	0
王承渲我们挺你	王承渲	1
后面是孟子义吗	孟子义	0
宝贝大佬康康爱宝贝大佬林鹿	康康	1
真不让人省心！汤圆在此锤了一下王源！！！	王源	0
哪吒只是想交个朋友而已，你们凭什么欺负他呀，大家不都是好朋友吗？	哪吒	0
邹思扬好看！	邹思扬	1
哪位哥哥姐姐弟弟妹妹叔叔阿姨告诉我一下为什么虞书欣这么火🔥？	虞书欣	0
罗槟你姐姐怎么在这里	罗槟	0
白幼宁也太讨厌了吧，哪有她这样的	白幼宁	-1
希望屏幕前的各位投下徐轸轸，王承渲，陈品瑄	王承渲	1
宋昕冉太好看了！！！！！	宋昕冉	1
牧尘：明天见	牧尘	0
金子涵你勾引我你要负责啊啊啊	金子涵	1
王承渲明明是最努力的那个，眼睛呢，	王承渲	1
我是小哪吒，逍遥又自在，那去了	哪吒	0
救喜欢蔡卓宜！！！！！	蔡卓宜	1
刘令姿好好看啊	刘令姿	1
王俊凯可以啊	王俊凯	1
孔雪儿孔雪儿孔雪儿孔雪儿孔雪儿	孔雪儿	0
金子涵！！！！金子涵！！！！金子涵！！！！金子涵！！！！	金子涵	1
刷肖战的人没有马	肖战	-1
要是修音，那孔雪儿修了音还那么差咋能是A啊	孔雪儿	0
金子涵和安琦好搭	金子涵	1
许佳琪冲冲冲	许佳琪	1
戴燕妮谢可寅刘雨昕黄小芸金子涵刘亚楠王承渲安崎赵小棠	谢可寅	0
李现李现李现	李现	0
刘欢老师是你吗？	刘欢	0
陈珏别不说话啊，没镜头了都	陈珏	0
申冰连名字显示都没有，笑死	申冰	0
这部剧什么时候郭德纲赵本山成龙周润发刘德华他们出来，就为了看他们。。。。。。。。。。。。。。。。。	郭德纲	0
是啊蕊蕊高兴的和不了嘴了	蕊蕊	0
欧阳娜娜演技有进步，不过还是挺烂的	欧阳娜娜	0
周冬雨应该比千千大很多吧？	周冬雨	0
女娲拿来抓袁洪的山河社稷图	袁洪	0
王源sb本色出演	王源	-1
莎莎也太可爱了吧，简直就是人间芭比，啊啊啊啊啊	莎莎	1
许佳琪，我想跟你暖被窝	许佳琪	1
这是有点想取代白娘子赵雅芝？	白娘子	0
蕊蕊真是可爱了，怕不是个小吃货	蕊蕊	1
给喻言多点镜头	喻言	0
坤哥看穿了一切	坤哥	1
陈珏太厉害了	陈珏	1
太乙真人拿的是哪吒，申公豹拿的是敖丙	申公豹	0
上官喜爱长得真的太丑了	上官喜爱	-1
韩雪是军人家庭，家里都是军官	韩雪	0
王承渲加油啊，集美们快来pick吧，入股不亏哦！	王承渲	1
黄小芸有一点点像我老公二字源源耶	源源	0
太可爱了吧孔雪儿	孔雪儿	1
？？？lisa申洁可是专业抓眼球的哦	lisa	0
路飞到底有几种形态？	路飞	0
我觉得冰清玉洁最好的还是申洁，申洁比其他三个有自知之明，也比其他三个努力	冰清玉洁	0
哪个不比孔雪儿强？	孔雪儿	-1
小宁马乐割逼的太阳	小宁	-1
八臂哪吒太帅了！！！！！！！	哪吒	1
为啥哪吒的眼睛很大呀?	哪吒	0
真自恋，申洁的实力不知比人家差多少呢	申洁	-1
确实比袁娅维唱的好听	袁娅维	-1
胡一天说的中文，后期配音配的英文	胡一天	0
孔雪儿配a吗？	孔雪儿	-1
范闲：好吧，猫腻这人忒坏，残忍，我认了	范闲	0
眼里只有安崎	安崎	1
安崎好有气场！！！	安崎	1
啊啊啊谢可寅刘雨昕！！！	刘雨昕	1
秦牛正威好丑	秦牛正威	-1
第二名徐佳莹	徐佳莹	0
段小薇真的好恶心	段小薇	-1
不不不王承渲想的是团体你想的是自己和自己的姐妹😋别把自己说的那么高尚我们不是瞎	王承渲	0
袁娅维！！！	袁娅维	1
为什么我没有看到秦牛正威啊	秦牛正威	0
孔雪儿滚吧，骂蔡徐坤	孔雪儿	-1
呵呵导师说的都是对的，申洁没能力，，，	申洁	-1
乔楚生！乔楚生！看唇形是乔楚生！	乔楚生	0
安琪有1米6	安琪	0
沈腾眉毛挑的好像郭达	沈腾	0
其实我觉得这种特爱笑的女生才更心机，我觉得孔雪儿跟她比倒真实些	孔雪儿	0
蔡依林蔡依林亚洲天后	蔡依林	1
蔡卓宜冲冲冲	蔡卓宜	0
我想要肖战啊啊啊	肖战	1
华晨宇！华晨宇！华晨宇！！	华晨宇	0
邓紫棋，哇哦哦哦哦哦哦哦哦哦	邓紫棋	0
林小宅超过我期望，以为没什么实力，但实际表现的不错	林小宅	1
虞书欣虞书欣虞书欣虞书欣虞书欣虞书欣虞书欣虞书欣虞书欣虞书欣虞书欣虞书欣虞书欣虞书欣虞书欣虞书欣	虞书欣	0
就是乔楚生我看了十几次了不可能错！	乔楚生	0
王承渲比申杰好	王承渲	1
申洁跳舞不行管闲事挺牛逼	申洁	-1
我的虞书欣，林小宅呢？！	虞书欣	0
魏莱可以试试欺负我	魏莱	0
蕊蕊这下颚线爱了	蕊蕊	1
金子涵孔雪儿加油！！！	孔雪儿	1
这是牧尘的计划吗	牧尘	0
梁博再来次吧	梁博	0
如果敖丙赢了，他就是正义的龙族得到了解放，哪吒赢了他就是正义的，拯救了在场的人	敖丙	0
那是易烊千玺！！	易烊千玺	0
华晨宇华晨宇华晨宇华晨宇华晨宇华晨宇	华晨宇	0
安娜疯了吗？😱😱😱😱😱😱	安娜	0
金子涵真的好像周子瑜，长相性格都像	金子涵	0
好可爱呀哪吒❤️💞💖❣️💓💘💕💗💝💟♥️	哪吒	1
艾莎和安娜你，我真的很想见那个安娜，有病。	安娜	0
金子涵冲冲冲	金子涵	1
不怎么喜欢王欣宇	王欣宇	-1
周深好棒～喜欢毛毛爱毛毛	毛毛	1
申公豹不是姜子牙师弟吗？怎么成太乙真人师弟了？？？？！！	申公豹	0
申公豹你就是个垃圾	申公豹	-1
我跟娄艺潇一个姓	娄艺潇	0
那些花啊，沈腾夏洛特烦恼	沈腾	0
真的是臭不要脸，特别是那个申冰，真的神经病，哪里来的脸说她好	申冰	-1
我就想知道秦牛正威和申洁的票是咋来了，我天，不是买的就是投票的瞎！！！！！！！顶我	秦牛正威	-1
属于王承渲的东西终究会还回来的	王承渲	0
戴萌我路转粉了，真的好暖	戴萌	1
魏辰魏辰魏辰魏辰魏辰魏辰魏辰魏辰魏辰！	魏辰魏辰	0
坤哥一语道破	坤哥	0
哪吒是好孩纸	哪吒	1
毛毛被欺负了，被人利用啊	毛毛	0
孟子义，陈情令里的温情	陈情令	0
这个艾莎是不会同意的。	艾莎	0
让我想起周杰伦和方文山	周杰伦	0
蔡卓宜太漂亮	蔡卓宜	1
你一票我一票安崎C位出道	你一	0
那蔡卓宜除了会笑还会啥？去了女团又没有实力，拖后腿吗？？	蔡卓宜	-1
nice，不过剪辑师让我想起那英的那那件事！剪辑师很商量，台下观看的小姐姐也都很善良！～(￣▽￣～)	nice	0
孔雪儿五官不好看	孔雪儿	-1
穿衣服照镜子在后面，申公豹跟着出场	申公豹	0
哪吒的配音太尬了	哪吒	-1
这不是悟空吗？	悟空	0
柳岩怎么什么也没玩	柳岩	0
此剧郑毓芝老师跟许还山老师分别以83岁82岁高龄出演确实令人敬佩！	郑毓芝	1
戴燕妮来啦！	戴燕妮	0
金子涵金子涵金子涵金子涵	金子涵	0
渲更抢眼啊！不过申洁有亮点，申冰不要脸，怕了怕了	申冰	-1
左卓左卓左卓冲啊！	左卓	1
杨迪的这身衣服总能想到黄渤。	杨迪	0
张总唱功比小王好	张总	1
陈念太善良懂事，很心疼	陈念太	1
所有人里面最讨厌冰清玉洁，秦牛正威，蔡卓宜，黄一鸣，莫寒，尤其蔡卓宜音准不会舞蹈也不会，不知道来干嘛	冰清玉洁	-1
许杨玉琢加油	许杨玉琢	1
说真的，都比孔雪儿好	孔雪儿	-1
我要是有蔡卓宜这张脸我还用去学唱跳？我去当保安都行	蔡卓宜	1
安崎我爱你呜呜呜	安崎	1
人家杨迪知识面广泛，没你们蠢	杨迪	1
林小宅真的好漂亮啊	林小宅	1
魏莱的家庭教育问题很大	魏莱	0
唉，王源啊，你要是能看见多好，扶你的这位可要抢你媳妇啊	王源	0
许佳琪冲啊！	许佳琪	1
徐轸轸爱你！！给我冲	徐轸轸	1
小葵出来放风啦	小葵	0
想到申冰当三退赛我就舒坦	申冰	-1
长公主私通皇子~	长公主	-1
薛之谦怎么不来啊	薛之谦	0
谢可寅和虞书欣就是我的快落源泉	虞书欣	1
顺子迷离的眼神	顺子	1
她也是好声音里的，-汪峰战队的	汪峰	0
蔡徐坤说出了真相	蔡徐坤	0
蔡卓宜啊啊啊冲呀！	蔡卓宜	1
其实我觉得小王并不适合A	小王	0
哪吒国足需要你啊	哪吒	0
孔雪儿太不行了吧	孔雪儿	-1
洛璃快来揍他一顿	洛璃	0
周深周深和毛毛好甜啊啊啊啊	周深	1
林小宅真的挺努力的感觉	林小宅	1
人家说的是马来西亚邓紫棋	邓紫棋	0
留个名：易烊千玺老婆单靓雯	易烊千玺	1
蔡徐坤原来喜欢这种类型	蔡徐坤	0
这是美队加哪吒？	哪吒	0
这是哪吒最开心的一天	哪吒	0
一帮杠精两个小时不还有姜子牙预告了我咋看不出少了啥	姜子牙	0
艾玛给黑山老妖一样	黑山老妖	0
陈珏下来换喜爱	陈珏	0
孔雪儿我好爱	孔雪儿	1
黄小云有点像王源	黄小云	0
金子涵好美的！！	金子涵	1
王承渲当C位是OK的！！！冰清玉洁真的对他们无语……	冰清玉洁	-1
明显安崎厉害啊	安崎	1
注意看申公豹周围的颜色。	申公豹	0
就是比孔雪儿出来的晚，要不然她们是首A	孔雪儿	-1
莎莎的镜头是甜甜的呀	莎莎	1
葛鑫怡葛鑫怡葛鑫怡葛鑫怡葛鑫怡葛鑫怡葛鑫怡葛鑫怡葛鑫怡葛鑫怡葛鑫怡葛鑫怡葛鑫怡葛鑫怡葛鑫怡葛鑫怡冲冲	葛鑫怡	0
哇呜情敌见面分外眼红打起来我赌牧尘赢	牧尘	0
无语了何美延	何美延	-1
比什么孔雪儿好多了	孔雪儿	-1
哪吒有六只手	哪吒	0
哇哦冯若航！！	冯若航	1
申公豹的师兄是姜子牙啊	姜子牙	0
魏辰啊出道吧！！大家看看魏辰妹妹	魏辰	1
白幼宁王八蛋	白幼宁	-1
赵雪爱蔡徐坤	赵雪爱	0
牧尘听你媳妇的	牧尘	0
许佳琪一定要出道啊	许佳琪	1
范丞丞范丞丞范丞丞范丞丞范丞丞范丞丞范丞丞范丞丞	范丞丞	0
虞书欣虞书欣冲啊	虞书欣	1
好担心牧尘的身体。	牧尘	0
葛鑫怡加油！！！	葛鑫怡	1
刘雨昕我来了	刘雨昕	0
说王俊凯的你瞎吗	王俊凯	0
阿丑：哪吒抢我妹	阿丑	0
许佳琪不是第一个举手的啊	许佳琪	0
喜欢花花，毛毛，萧敬腾	花花	1
希望屏幕前的各位投下徐轸轸，王承渲，陈品瑄	徐轸轸	1
这组是不是换成了王承渲C？	王承渲	0
陈珏陈珏陈珏	陈珏	0
徐紫茵可以！值得！	徐紫茵	1
陈，，，陈坤？	陈坤	0
陈老师演皇帝对你没什么影响吧	陈老师	0
阿炳阿炳，别小看哪吒他会变申数	阿炳	0
你们在一起吧！牧尘我的😁😁	牧尘	0
我个人不喜欢王俊凯	王俊凯	-1
李小璐后悔死了	李小璐	0
毛毛老师加油	毛毛	1
哇你不喜欢不代表别人不喜欢呀，蔡卓宜粉丝也很多好不好	蔡卓宜	1
言冰云是肖战	言冰云	0
温宁思追有了，聂明玦聂怀桑有了，是不是还要来金陵江澄	江澄	0
唱的不错，但是比不了邓紫棋	邓紫棋	0
毛毛这两个太可爱了，哈哈	毛毛	1
留个名张天爱	张天爱	0
期待虞书欣💓💓	虞书欣	1
感觉许佳琪比孔雪儿好一点	孔雪儿	-1
八卦之王，丽萨	丽萨	0
沙币杨迪这么恶心	杨迪	-1
安崎优秀！！！！	安崎	1
蔡卓宜棒棒哒	蔡卓宜	1
蔡卓宜真的超甜	蔡卓宜	1
胡子哥叫黄觉	胡子哥	0
戴萌加油加油	戴萌	1
王菲可不能和她比	王菲	0
旁边申洁骂了句艹，有没有人听到	申洁	0
金子涵金子涵冲冲冲	金子涵	0
张新成张新成	张新成	0
为什么没有人说易烊千玺	易烊千玺	0
为什么哪吒生气的时候眼珠是白的	哪吒	0
那为什么孔雪儿是首A？不应该是这两组先表演吗，，，，，，，	孔雪儿	0
真的超喜欢安崎	安崎	1
我好心疼邓紫棋	邓紫棋	0
申洁能不能好好学一下表情管理老呲牙咧嘴的干嘛	申洁	0
陈道明的台词已经不能算台词了，他说话做事一样	陈道明	1
葛鑫怡好可爱！	葛鑫怡	1
滕梓荆是谪守巴陵郡的那个吗？	滕梓荆	0
虞书欣冲冲冲冲	虞书欣	1
小太阳是陆定昊，你不配	陆定昊	0
金子涵金子涵	金子涵	0
我真的不明白孔雪儿怎么就成a了呢照这么说我觉得她们都有资格做a啊	孔雪儿	-1
牧尘实在保护你啊慕白	牧尘	0
白幼宁咋那么作死呢	白幼宁	-1
孔雪儿那都丑	孔雪儿	-1
申洁不配当C位	申洁	-1
陈珏加油！！	陈珏	1
孔雪儿到底哪点好了。。	孔雪儿	-1
韩雪的妈妈长得好像林心如	韩雪	0
牧尘这个小笨蛋，这么笨，被人拐跑怎么办	牧尘	-1
孔雪儿整崩了，以前还挺可爱的，就是爱勾搭男人	孔雪儿	-1
青2是青2弹幕怎么老提张艺兴粉丝太败好感了吧	张艺兴	0
给我送蔡卓宜出道	蔡卓宜	1
有点像沈梦辰和林志颖的合体	沈梦辰	0
曾小贤的灰夏利	灰夏利	0
鹿晗现在怎么看不见了	鹿晗	0
好心疼哪吒啊！	哪吒	1
申冰本身就是婊抢别人的男朋友	申冰	-1
刘令姿刘令姿刘令姿刘令姿刘令姿刘令姿	刘令姿	0
申洁跳的什么鬼谁会看这种C位	申洁	-1
金子涵冲冲冲	金子涵	1
许佳琪冲冲冲!!!	许佳琪	1
喻言几年前参加过加油美少女一头嚣张粉发选了c位实力印象深刻！	加油美少女	0
哈哈哈哈哈刘雨昕刘令姿我的最pick	刘令姿	1
哪吒小时候长得非常丑。	哪吒	-1
徐轸轸徐轸轸徐轸轸	徐轸轸	0
刘雨欣开始看了吗？	刘雨欣	0
金子涵金子涵金子涵金子涵金子涵	金子涵	0
觉醒东方不是比孔雪儿好吗，居然没有A	孔雪儿	-1
牧尘快回来。	牧尘	0
许佳琪，许佳琪上PK一下PK一下，许佳琪，许佳琪	许佳琪	0
白真的好恶心。。。	白真	-1
哪吒放大招了	哪吒	0
留个名，周杰伦	周杰伦	0
蔡卓宜我不可，脸有一点宽，不好意思	蔡卓宜	0
徐紫茵正片一剪梅厦门双十的学霸姐姐！pick她！	徐紫茵	1
pick王总出道！！怎么不能是女团！！	王总	0
蔡卓宜我爱你＾3＾	蔡卓宜	1
蔡徐坤的包袱不允许他明显的做出这个动作哈哈哈哈	蔡徐坤	0
唉牧尘还帮慕白找老师	慕白	0
孔雪儿嘴凸，不耐看	孔雪儿	-1
金子涵有点AOA雪炫是感觉	金子涵	0
不是孙千！！！！！！！！！！！！！！！	孙千	0
拜托你们别在那说蔡徐坤不严格。是所有老师一起决定等级，好吗？	蔡徐坤	0
张涵予，最棒	张涵予	1
我觉得这老师察觉到牧尘的厉害了	牧尘	1
哪吒的爹是李静哪吒的娘是什么？	哪吒	0
虞书欣冲冲冲	虞书欣	1
哈哈哈哈孔雪儿太可爱了吧	孔雪儿	1
张伟一句话暴露了自己的自恋。	张伟一	0
李现肖战候明昊王鹤棣敖瑞鹏张云龙胡一天保护我	敖瑞鹏	0
好可爱的哪吒啊	哪吒	1
徐紫茵演过老师好和大宋少年志一个跑龙套的	徐紫茵	0
陈念在前小北在后	小北	0
我是谁你是谁，我是你爹，你是谁，蔡徐坤nmsl	蔡徐坤	-1
啊！我太爱毛毛了！我来就是看毛毛和花花的	花花	1
还是最爱许佳琪	许佳琪	1
我爱你华晨宇!	华晨宇	1
孔雪儿孔雪儿孔雪儿冲冲冲	孔雪儿	1
哪吒力气真大	哪吒	0
这个申冰说话怎么这样	申冰	0
确实比王菲强	王菲	-1
不要喷申洁了，如果你是4胞胎里的一个，你当然也会投自己的姐姐妹妹呀！	申洁	0
王子轩，最讨厌的人。	王子轩	-1
安崎应该是首A的	安崎	1
哪吒真会画😄	哪吒	0
安崎有霸气护体	安崎	0
王青像汤唯和钟丽缇的结合	钟丽缇	0
邓紫棋的歌?在林宥嘉面前唱?节目组胆子真大，炒热度炒到这种地步，NB	林宥嘉	0
王思予好少镜头	王思予	0
白幼宁就这样是早了不会喜欢路垚的，但凡有点感情都不会这么做的	白幼宁	0
王承渲加油加油加油！！！！！！	王承渲	1
王思予好酷好可爱！！	王思予	1
蔡卓宜长得无可挑剔	蔡卓宜	1
随便一个比孔雪儿强	孔雪儿	-1
本来还挺喜欢Ella老师的，但是这么说张溪杨蕊菡张楚寒就有一点过分了吧毕竟你在101还是很喜欢她们的	张溪	0
刘亚楠，刘亚楠，刘亚楠	刘亚楠	0
陈品瑄好好！！！！	陈品瑄	1
蔡卓宜冲冲冲	蔡卓宜	1
傅如乔好可爱	傅如乔	1
王思予一直在飚高音就这票就这？？？妹妹高音根本不给镜头辣鸡爱奇艺只认钱	王思予	0
陆柯燃冲冲冲	陆柯燃	1
现场观众的我不知道，反正我就是喜欢毛毛的娓娓道来	毛毛	1
徐佳莹神经病一个	徐佳莹	-1
王心铭和王承渲好像啊是姐妹吗	王承渲	0
突然觉得孔雪儿也不错	孔雪儿	1
怎么有点像王源	王源	0
申公豹也太坏了吧。	申公豹	-1
孔雪儿真的不配	孔雪儿	-1
在小红书上的安娜就是我。	安娜	0
好男人就是我，我就是吕子乔	吕子乔	0
熊大，光头哪吒来砍树了	熊大	0
呼叫韩红来镇压	韩红	0
张新成太爱了	张新成	1
哪吒：这样就可以打出字？	哪吒	0
肖战和陈道明都是配角啊	肖战	0
你个垃圾，你和许佳琪你简直太弱了	许佳琪	-1
觉醒东方这组哪个不比孔雪儿好	孔雪儿	-1
留个名李志国	李志国。	0
陈珏啊啊啊啊啊冲冲冲	陈珏	0
戴燕妮谢可寅刘雨昕黄小芸金子涵刘亚楠王承渲安崎赵小棠	王承渲	0
长公主真委屈	长公主	0
上官喜爱这一句霸气啊！	上官喜爱	1
上官喜爱不适合女团，给人的感觉太拽了	上官喜爱	-1
林小宅怎么这么丑	林小宅	-1
留个名蔡徐坤	蔡徐坤	0
金子涵金子涵金子涵金子涵金子涵金子涵金子涵金子涵冲鸭	金子涵	1
葛鑫怡葛鑫怡葛鑫怡葛鑫怡葛鑫怡葛鑫怡葛鑫怡葛鑫怡葛鑫怡葛鑫怡葛鑫怡葛鑫怡葛鑫怡葛鑫怡葛鑫怡葛鑫怡冲冲	葛鑫怡	0
李沁，张天爱真美	张天爱	1
这几个跳的我喜欢许佳琪	许佳琪	1
大力张伟情侣装	张伟	0
张新成张新成	张新成	0
许佳琪下巴做的太尖吓人	许佳琪	-1
杨迪的这身衣服总能想到黄渤。	黄渤	0
喜欢孔雪儿的祝你们的男朋友也被人抢哦孔雪儿抢男人第一名	孔雪儿	-1
金子涵你是最棒的	金子涵	1
徐紫茵和声唱的也太好听了！！	徐紫茵	1
关键是上官喜爱还没A孔雪儿就A了？	孔雪儿	-1
关晓彤演技真的差	关晓彤	-1
你个假粉，这是王俊凯	王俊凯	0
哪吒好可爱也好可怜	哪吒	1
左卓左卓左卓左卓	左卓	0
张耀，李师傅！！！！超帅的	张耀	1
繁星坠入我眼里，喻言坠入我心里✨	喻言	1
王琳凯保护我，蔡徐坤保护我，陈立农保护我。	陈立农	0
是我我会把魏莱毁容	魏莱	0
大哪吒厉害。	大哪吒	1
e魏莱被陈念手误给杀了，小北背的黑锅	魏莱	0
熊大，光头哪吒来砍树了	光头	0
巨星毛不易，我想薛之谦了	薛之谦	1
安崎！！！！！！！！！！！！！！我死了！！！	安崎	0
李易峰保护我	李易峰	0
刘令姿给我冲！！！！	刘令姿	1
金子涵太美了	金子涵	1
王承渲自信点妈妈爱你	王承渲	1
真心不喜欢孔雪儿	孔雪儿	-1
我也看好张总	张总	1
申冰:就算你是导师你也不能这样说！	申冰	0
安崎气场爆炸💥	安崎	1
喜欢赵海棠哈哈哈哈哈	赵海棠	1
段艺璇我来了	段艺璇	0
陈品瑄好甜！！！！	陈品瑄	1
蔡卓宜不耐看	蔡卓宜	-1
牧尘好聪明啊！牧尘主意好多好多。	牧尘	1
房东姐姐像范冰冰	范冰冰	0
金子涵金子涵金子涵金子涵冲冲冲	金子涵	1
急着被人接受，一时情急，哪吒本性本来就不坏	哪吒	0
徐紫茵加油冲！！	徐紫茵	1
哪吒身上有太乙下的咒抑制了大部分魔力所以体型也有所影响	哪吒	0
金子涵金子涵，啊啊啊！！！！	金子涵	1
安崎！！！！！！给我冲	安崎	1
不是，关晓彤又太好看了我滴妈	关晓彤	1
孔雪儿滚吧，骂了蔡徐坤还有脸来参加	孔雪儿	-1
我的天啊，申冰，我的天真是不要face	申冰	-1
可现实生活中的陈念没有小北啊	小北	0
我马蜀君呢？	马蜀君	0
林彦俊我喜欢你！！	林彦俊	1
四姐妹果然申冰还算好看些，怪不得......hiahiahia	申冰	0
徐天又跑这坑妹妹来了，坑完大哥坑妹妹	徐天	0
长公主发型真丑	长公主	-1
莎莎也太可爱了吧，简直就是人间芭比，啊啊啊啊啊	芭比	1
看看魏辰吧，妹妹很厉害的	魏辰	1
安崎好好看！！！！！！	安崎	1
金子涵啊啊啊啊啊我急死这样没镜头啦😂😂😂😂	金子涵	1
邓紫棋的歌真的好	邓紫棋	1
孔雪儿你一定要作妖刷存在感吗	孔雪儿	-1
牧尘实在保护你啊慕白	慕白	0
哈哈哈哈哈哈蔡徐坤好搞笑	蔡徐坤	1
刘令姿刘令姿刘令姿刘令姿刘令姿刘令姿刘令姿刘令姿刘令姿刘令姿刘令姿刘令姿刘令姿刘令姿刘令姿刘令姿刘令	刘令姿	0
喻言笑起来好好看	喻言	1
文哲长得有点像颖儿	颖儿	0
新片头,牧尘好酷	牧尘	1
虞书欣冲啊！1号位真好，希望一直这样，欣欣也加油！	虞书欣	1
申洁她有那个亮点（狗头）	申洁	1
不是得第一的才有100秒表演时间吗？不是虞书欣吗？怎么是许佳琪了！	虞书欣	0
孔雪儿还是算了吧路人不喜欢她，他私生活太乱了	孔雪儿	-1
蔡徐坤太可爱了吧	蔡徐坤	1
好喜欢王总和张总啊！！！太快乐了	张总	1
孔雪儿怎么一脸不爽的样子，真的这个舞台她没有多好	孔雪儿	-1
安琪干起来肯定很爽	安琪	-1
吴凡1314	吴凡	0
来了来了！！喻言来了！！！	喻言	0
顺子都听的入迷了	顺子	1
天天来蕊蕊这里打卡	蕊蕊	1
我爱了虞书欣	虞书欣	1
刘令姿不能一轮游啊啊啊啊啊大家救救孩子吧	刘令姿	1
王源和王俊凯演得真好	王俊凯	1
金子涵出道金子涵出道金子涵出道金子涵出道金子涵出道金子涵出道金子涵出道金子涵出道金子涵出道金子涵出道	金子涵	1
王承渲真的很厉害，很棒	王承渲	1
蕊蕊亲爹是谁	蕊蕊	0
韩雪有点不喜欢，包袱有点重	韩雪	-1
刘亚楠恶心死了赶紧滚赶紧滚校园霸凌她不配	刘亚楠	-1
故意的你说申冰一个小三能说出什么好话	申冰	-1
老高你最油腻	老高	-1
金子涵！！！！金子涵！！！！金子涵！！！！金子涵！！！！	金子涵	1
孔雪儿真的很士垃圾好吗❓❗️❗️	孔雪儿	-1
华晨宇！华晨宇！华晨宇！！	华晨宇	0
我pick爆安崎	安崎	1
能有几个A是毫无争议！至今只有蔡徐坤而已！	蔡徐坤	0
孔雪儿是个狐狸精啊心机婊s。温柔个屁啊抢别人老公婊子	孔雪儿	-1
杨幂冲啊妈妈爱你	杨幂	1
肖战怎么啦，你们别黑战战不行吗	战战	0
虞书欣冲鸭！！	虞书欣	1
徐紫茵可以呀	徐紫茵	1
王承渲冲啊啊啊啊！	王承渲	1
孔雪儿怎么啦？看实力说话好吗？	孔雪儿	0
徐锦江是你么	徐锦江	0
难道不觉得蔡卓宜和沈梦辰很像吗	沈梦辰	0
魏辰很棒啊！	魏辰	1
郑玉歆酷~~	郑玉歆	1
林凡林凡林凡宝贝冲冲冲	林凡	1
刘令姿！给老娘出道！	刘令姿	1
王承渲可甜可咸啊啊啊啊	王承渲	1
李现李现李现	李现	0
孔雪儿好好看也有实力我好爱	孔雪儿	1
向佐怎么唱歌那么好？	向佐	0
程巨树来演小北	小北	0
弹幕别烦了好吗安崎实力好不好导师会看。说别人用力过猛这舞蹈本来就这样的吧而且安崎如果实力不好lisa也不会夸她	lisa	0
所以，不是小北？	小北	0
说商菊贞的怕是傻子吧！侯玉魁都说了当时是和商菊贞，宁九郎，姜荣寿同台的时候偷听到的。	商菊贞	0
戴燕妮之前为什么给一剪没了，我好气	戴燕妮	0
李沁，张天爱真美	李沁	1
蔡卓宜我爱辽	蔡卓宜	1
宋继扬保护我	宋继扬	0
哇安崎好好啊	安崎	1
邓紫棋的歌太好听了啊啊啊啊啊啊啊啊啊	邓紫棋	1
收放自如，不愧是我安崎！！	安崎	1
你们干嘛呢我是申公豹	申公豹	0
小北哭的嘴唇抽搐	小北	0
真的，我就没看到过几次黄欣苑的镜头	黄欣苑	0
金子涵总让我想到周子瑜	金子涵总	0
薛之谦薛之谦薛之谦薛之谦薛之谦	薛之谦	0
丽萨借要帮小贤除草啦	丽萨	0
申冰不配拥有姓名哈哈哈，训练生哈哈哈哈哈	申冰	-1
喻言喻言喻言冲冲冲	喻言	0
你一票，我一票，佳琪明天就出道	佳琪	0
快乐，我最喜欢的就是这组的第一第二欸，我喜欢金子涵与安琦	金子涵	1
关晓彤好像还在上学？！	关晓彤	0
干嘛要请林宥嘉台独渣男	林宥嘉	-1
魏辰镜头好少	魏辰	0
呜呜呜王承渲和陈品瑄两个都很棒鸭别哭别哭	王承渲	1
安崎的眼神我滴妈呀！！awsl！！我真的🉑🉑🉑	安崎	1
葛鑫怡太可爱了哈哈哈哈	葛鑫怡	1
王源演得很好	王源	1
安崎太矮了，不适合女团	安崎	-1
啊啊啊啊徐轸轸我爱你！！	徐轸轸	1
哪吒的配音演员是个女哒	哪吒	0
喻言姐姐太可了多给点镜头啊啊啊	喻言	1
你一票我一票，安崎明天就出道啊啊啊啊啊啊啊，安崎妈妈爱你啊啊啊啊啊	安崎	1
大家看看刘令姿吧太好看了	刘令姿	1
这时我想起了锦觅	锦觅	0
申洁你真绿茶	申洁	-1
金子涵金子涵金子涵金子涵	金子涵	0
蔡卓宜和孔雪儿必须出道	孔雪儿	1
孔雪儿和安琦跳的好	孔雪儿	1
陈珏陈珏陈珏	陈珏	0
左卓左卓左卓左卓	左卓	0
太帅了，哪吒申公豹就是个傻批。	申公豹	-1
文哲你站好了	文哲你	0
刘令姿这个身体条件真的是太优越了	刘令姿	1
孔雪儿碾压一切！	孔雪儿	1
韩雪太假，太夸张了	韩雪	-1
哪吒怎么闷闷不乐的？	哪吒	0
林凡林凡林凡宝贝冲冲冲	林凡	1
文哲太好看了	文哲太	1
秦牛正威冲啊让丙丙后悔去	秦牛正威	0
我好喜欢文哲的颜	文哲	1
沈腾以5G的速度接收信息，谢广坤以1Ｇ的速度接收，差距就是这么大	沈腾	0
三界里三个家伙不能惹，一个猴子，一个杨戬，一个哪吒	杨戬	0
张若昀割双眼皮了吗？	张若昀	0
李懂，我劝你善良	李懂	0
安崎好棒！！太负责了！！！	安崎	1
可是人家现在单身。。。林小宅现在是有男朋友来参加节目。。。	林小宅	0
刚刚有一瞬间感觉长的像郑恺	郑恺	0
第一次注意到这个银色背心女孩，郑玉歆	郑玉歆	1
葛鑫怡哈哈哈	葛鑫怡	0
蔡徐坤真的嚷嚷泪目	蔡徐坤	0
许佳琪许佳琪	许佳琪	0
王牌家族优越感太强了！柳岩说啥不搭理，要么就否定	柳岩	0
黄小芸好像王源啊	黄小芸	0
白幼宁是不是有神经病？咋这讨厌的！！	白幼宁	-1
林小宅我爱你	林小宅	1
金子涵妈妈爱你	金子涵	1
我一眼就觉得她像蔡依林	蔡依林	0
秦牛正威你哭啥呢，咋让大家熟知	秦牛正威	0
华晨宇辣个小子怎么那么有才华🌚	华晨宇	1
魏辰魏辰魏辰魏辰魏辰魏辰魏辰魏辰魏辰！	魏辰	0
魏辰魏辰魏辰魏辰魏辰魏辰魏辰	魏辰	0
烦死了，这个白幼宁，能不能早点领盒饭	白幼宁	-1
这里还有人说柳岩作你心是黑色吗	柳岩	0
葛鑫怡小姐姐加油！！！！	葛鑫怡	1
熊钰清太厉害啦	熊钰清	1
孔雪儿还跟闺蜜抢男朋友	孔雪儿	-1
王承渲真的是个好女孩	王承渲	1
真的不要刷肖战了，真的物极必反，本来不讨厌得，现在看到就烦，不要捧杀	肖战	0
牧尘乌鸦嘴啊	牧尘	-1
戴燕妮戴燕妮戴燕妮戴燕妮戴燕妮戴燕妮戴燕妮戴燕妮冲	戴燕妮	1
太帅了，哪吒申公豹就是个傻批。	哪吒	-1
许佳琪太酷了	许佳琪	1
杨迪挺好的呀	杨迪	1
汉斯王子坏的，没有良心的人	汉斯	-1
上官喜爱在女团里会太突兀了真的不适合	上官喜爱	-1
戴燕妮我爱你	戴燕妮	1
刘令姿刘令姿刘令姿❤️❤️❤️	刘令姿	1
留个名：易烊千玺老婆单靓雯	靓雯	0
孟子义，陈情令里的温情	孟子义	1
华晨宇华晨宇华晨宇华晨宇	华晨宇	0
我觉得王牌，有贾玲和沈腾就可以了，如果她俩不在，王牌也就没啥收视率了	沈腾	1
美佳在吕子乔跟他相遇的第一家医院认识的	美佳	0
哟这里是AKA秦牛正威	秦牛正威	0
孔雪儿人品不行	孔雪儿	-1
把我毛毛吓一跳！	毛毛	1
看过宋丹丹的就知道，沈腾不仅没招黑，还增加节目效果。这才是节目的目的，看输赢的去体育频道。	沈腾	1
文哲有点颖儿的感觉	颖儿	0
黄小芸我今天没票了我欠你两票！	黄小芸	1
哪吒：对不起了村民	哪吒	0
周冬雨皮肤好差啊	周冬雨	-1
安琪好好爱了	安琪	1
只要不是申洁就好	申洁	0
从白蛇缘起到哪吒，期待国漫崛起	哪吒	0
一大批托尼正在赶来的路上	托尼	0
蔡徐坤说的对，太对了	蔡徐坤	1
孔雪儿去过韩国练的好像	孔雪儿	0
这特么是徐锦江啊	徐锦江	0
神秘的美少女是娜美吧？话说娜美真的很美。	娜美	1
许佳琪我爱冲冲冲	许佳琪	1
路飞是那个将世界带向黎明的人	路飞	1
申公豹不是姜子牙师弟吗？怎么成太乙真人师弟了？？？？！！	太乙真人	0
花花来了。邓紫棋就不会来了	邓紫棋	0
做艺人嘛，难免的，只要不做违背道德的事就好！比如孔雪儿！品德就不行	孔雪儿	-1
坤哥和莎莎有一个镜头都没笑，表情也很牵强哈哈哈哈哈哈	莎莎	0
这个帅哥叫什么来着杜江？？真帅	杜江	1
呕吐，申冰滚吧你	申冰	-1
刘亚楠好可爱啊	刘亚楠好	1
让我想起周杰伦和方文山	方文山	0
艾莎和安娜你，我真的很想见那个安娜，有病。	艾莎	0
坤哥说实话了	坤哥	0
王牌对王牌第5季:沈腾贾玲模仿甜蜜蜜坐垮自行车华晨宇杨迪还原年画娃娃	沈腾	0
178：爱陈念	陈念	1
李现是流量狗	李现	-1
SNH48黄婷婷	黄婷婷	0
杨迪听得见，他说我都说完了，你才说，戴耳机呢	杨迪	0
为华晨宇而来有一点点喜欢他喔路转粉啦要	华晨宇	1
说的好！莎莎太棒了！	莎莎	1
金子涵太美啦！！	金子涵	1
刘德华果然最帅	刘德华	1
乔楚生我感觉就是废物光猜测无语	乔楚生	-1
徐紫茵的业务能力超强啊	徐紫茵	1
许佳琪啊啊啊啊	许佳琪	1
太太太喜欢安崎了	安崎	1
王源还会骑摩托啊	王源	0
王清！！！！陈珏！！！	陈珏	0
秀芬必知热知识:dance组歌都是提前录的	秀芬	0
蔡徐坤我爱你我爱你啊啊！！！！！	蔡徐坤	1
哪吒的要求其实很简单	哪吒	0
姐妹虞书欣是第一	虞书欣	1
这个人估计就是杀范闲母亲的人之一	范闲	0
王承渲冲！！！！	王承渲	1
许佳琪，许佳琪上PK一下PK一下，许佳琪，许佳琪	许佳琪	0
薛之谦，邓紫棋	薛之谦	0
林小宅广州的普通话不太好已经努力练习了	林小宅	1
金子涵出道金子涵出道金子涵出道金子涵出道金子涵出道金子涵出道金子涵出道金子涵出道金子涵出道金子涵出道	金子涵	1
跟蔡依林没法比好吗	蔡依林	0
他的口型是乔楚生！！！！姐妹们！！！！！	乔楚生	0
牧尘不要想信他炅坏人	炅坏人	0
金子涵成绩公布的时候感觉怯生生地看孔雪儿	金子涵	0
可恶的血灵子，等牧尘成了大主宰，你再和他斗！	牧尘	0
虞书欣本来就不好看，他也就占了似的便宜。他显得老。	虞书欣	-1
王欣宇我吐了	王欣宇	-1
这个白幼宁好贱。	白幼宁	-1
你这是曾小贤留给你的吧	曾小贤	0
郭麒麟演的不错	郭麒麟	1
刘令姿要露出她的马甲了！！！	刘令姿	0
汪睿小姐姐加油！！！	汪睿	1
陈珏、陆柯燃、王清，给我冲	王清	1
陈美嘉:我自己都不知道我这么会想	陈美嘉	0
小冉的发型真的难看	小冉	-1
夹缝中寻找王思予	夹缝中	0
魑魅魍魉真TM恶心，尤其是申冰，还会与别人老公互动	申冰	-1
戴燕妮谢可寅刘雨昕黄小芸金子涵刘亚楠王承渲安崎赵小棠	戴燕妮	0
哪吒的配音是为小姐姐	哪吒	0
牧尘怎么在这剧里这么弱啊	牧尘	-1
欢迎密码，你用心，你敏敏婆，魔攻，神龙龙大哪吒，小哪吒，刚生出来的小哪吒，奥比太乙真人。	奥比	0
LisaLisa宝贝Lisa宝贝Lisa，我就专门盯着莎莎看滴，爱死了啊啊啊啊啊啊啊啊啊啊啊啊啊啊啊	莎莎	1
这个欧豪一本正经的胡说八道！	欧豪	-1
谢可寅太可爱了哈哈哈哈哈哈哈哈哈	谢可寅	1
王源，范世琦，贾乃亮保护我	范世琦	0
张新成太棒了	张新成	1
这一帮中只对陈品瑄有好感直觉不错欧	陈品瑄	1
我就想知道秦牛正威和申洁的票是咋来了，我天，不是买的就是投票的瞎！！！！！！！顶我	申洁	-1
这是毛阿敏唱的嚒	毛阿敏	0
徐紫茵谢可寅许馨文都是下一站传奇的宝藏妹妹！！！！	许馨文	1
孙悟空会来吗	孙悟空	0
魏辰小可爱给点镜头吧！！！	魏辰	1
金子涵金子涵，金子涵金子涵。冲啊	金子涵	1
陈数眼睛变丑了啊	陈数	-1
金子涵金子涵金子涵金子涵	金子涵	0
莎莎把我收走呜呜呜	莎莎	1
真是醉了黄小芸镜头这么少？？	黄小芸	0
不喜欢蔡卓宜，天呐，就会卖萌	蔡卓宜	-1
该说不说申冰挺好看	申冰	1
大林本来就可爱	大林	1
周深周深和毛毛好甜啊啊啊啊	毛毛	1
这改的跟傻子似的，完全没有原著聪明的牧尘	牧尘	0
如果我是哪吒就好了	我是哪吒	0
申冰这个声音太恶心了吧？	申冰	-1
夹缝中寻找王思予	王思予	0
林小宅在这一组有点弱	林小宅	-1
申冰好傻逼不是我说	申冰	-1
柳岩学C罗庆祝动作	罗庆祝	0
巨星毛不易，我想薛之谦了	毛不易	1
孔雪儿哭就很烦蔡卓宜哭就跟着想哭靠	孔雪儿	-1
王承渲你最棒	王承渲	1
李小冉的妆好奇怪	李小冉	0
这组用什么唱？？麦克呢？？	麦克	0
留个名彭于晏	彭于晏	0
为什么我感觉申洁有点划水	申洁	-1
孔雪儿和安琦跳的好	安琦	1
哪吒本来就有黑眼圈	哪吒	0
虞书欣虞书欣虞书欣虞书欣虞书欣虞书欣虞书欣虞书欣虞书欣	虞书欣	0
毛毛怎么可能输？不看了	毛毛	0
吴宣仪甩头美的一批	吴宣仪	1
戴萌加油！！！	戴萌	1
曹贵修是配音吗？这声音也太好听了吧？好有磁性哦	曹贵修	0
申公豹要跳海了。	申公豹	0
留个名，王一博	王一博	0
真会说话，毛毛不是唱情歌的谢谢	毛毛	1
蔡徐坤你在干嘛？	蔡徐坤	0
熊大，光头哪吒来砍树了	哪吒	0
金子涵金子涵金子涵	金子涵	0
曾可妮明明有A的实力	曾可妮	1
娱乐圈离了肖战不活了？？？	肖战	-1
我终于忍不住要吐槽了陈美嘉和胡一菲整了容后没有前四部好看真可笑没整漂亮反而错了没了汪远还真不行	胡一菲	-1
孔雪儿长的好老！不喜欢	孔雪儿	-1
白真的很不懂得尊重人	白	-1
蔡卓宜也太可了叭	蔡卓宜	1
申冰是真的有病	申冰	-1
这就是太乙和申公豹的区别	申公豹	0
范丞丞范丞丞范丞丞范丞丞范丞丞范丞丞范丞丞范丞丞	范丞丞	0
有张靓颖的感觉	张靓颖	0
林宥嘉不尴尬吗？	林宥嘉	0
短头发的比孔雪儿好看	孔雪儿	-1
蔡卓宜真的努力了啊啊啊	蔡卓宜	1
刘令姿这个镜头看了也就百八十遍吧	刘令姿	1
秦牛正威能不能不要给镜头了烦死了	秦牛正威	-1
丑逼安琪滚丑逼安琪滚丑逼安琪滚丑逼安琪滚丑逼安琪滚丑逼安琪滚丑逼安琪滚丑逼安琪滚丑逼安琪滚	安琪	-1
这里这么多人都妒忌孔雪儿实力强啊	孔雪儿	1
垃圾黄霄云，毛毛最棒	毛毛	1
许佳琪许佳琪	许佳琪	0
蔡卓宜又没有什么梗，她为撒要洗白	蔡卓宜	0
丽萨以为他被绿了？	丽萨	0
大家给徐紫茵投票吧	徐紫茵	1
哪吒你怎么了！	哪吒	0
陆柯燃给老子冲冲冲	陆柯燃	1
王思予的镜头好少哦	王思予	0
蔡卓宜真的是青春2里最美的了，实话	蔡卓宜	1
大家给孔雪儿投投票吧	孔雪儿	1
王欣宇太做作了吧	王欣宇	-1
一代蜘蛛侠哈利的父亲	哈利	0
王承渲一直走在中间，当然醒目啦，最后一幕我不信你没有记得申洁。	王承渲	0
白幼宁讨厌的一批	白幼宁	-1
周冬雨是双眼皮吗	周冬雨	0
蔡徐坤我开始爱你了！	蔡徐坤	1
她也是好声音里的，-汪峰战队的	好声音	0
申冰说话这么贱呢	申冰	-1
这皇上是肖战扮演的吧	肖战	0
徐紫茵还挺好看	徐紫茵	1
这白幼宁五官不好看，人设也讨厌	白幼宁	-1
这是四个人的共同决定又不只是蔡徐坤的好吗	蔡徐坤	0
留个名，陆小凤，四条眉毛的陆小凤	陆小凤	0
拉拉和毛毛都是抒情歌，比较吃亏	毛毛	0
喻言全能vocal	喻言	1
可能以前有什么误解，现在看蔡徐坤不错嘛	蔡徐坤	1
这是张含韵吧	张含韵	0
看贾玲哭我想笑对8起哈哈哈哈哈	贾玲	0
哪吒刚才说丢人丢到家了，啦啦啦啦啦啦啦了	哪吒	0
孔雪儿孔雪儿孔雪儿	孔雪儿	0
申洁啊你才卧槽呢是真的不尊重人	申洁	-1
和尤长靖一个口音哈哈哈哈	尤长靖	0
虞书欣！！！	虞书欣	0
申洁的一张大脸吓到我了	申洁	-1
这是易烊千玺	易烊千玺	0
徐天啊！怎么不带田丹一起	徐天	0
牧尘，有人对你媳妇动手又动脚的	牧尘	0
葛鑫怡加油加油	葛鑫怡	1
华晨宇华晨宇华晨宇	华晨宇	0
王一博什么时候来	王一博	0
王思予王思予王思予王思予王思予王思予王思予王思予	王思予	0
这就看出来七穗和蔡卓宜实力的差距了	七穗	0
张新成，加油呀。	张新成	1
金子涵金子涵	金子涵	0
牧尘心疼媳妇了	牧尘	0
李小冉只适合短发呀	李小冉	0
虞书欣第一真的无语	虞书欣	-1
金子涵肯定很乖，很爱撒娇	金子涵	1
这一堆可能是吴京他们	吴京	0
顺子迷得不要不要的	顺子	1
申冰这作的程度没把自己作呕？	申冰	-1
魏辰魏辰魏辰	魏辰	0
娱乐圈火的并不都是靠颜的，我觉得张新成有颜有实力，而且并不是宁说火不长就火不长的	张新成	1
好几年前张语格的声音	张语格	0
牧尘这里把瞎子靠声音分辨方向演绎得到位	牧尘	0
那个不是李渔嘛？	李渔	0
王承渲你最棒不要太善良好不好心疼死了	王承渲	1
蔡徐坤你在干嘛哈哈哈	蔡徐坤	0
Lisa说了，申洁抓不了眼球	申洁	-1
我杰森打起架来怎么这么帅	杰森	1
许佳琪许佳琪许佳琪许佳琪许佳琪许佳琪许佳琪许佳琪许佳琪许佳琪许佳琪许佳琪许佳琪许佳琪许佳许佳琪许佳琪	许佳琪	0
哈哈哈哈哈哈哈哈哈哈哈哈哈哈哈哈哈贾玲好有梗	贾玲	1
护身符就是那个符咒，在哪吒身上	哪吒	0
许佳琪，许佳琪，许佳琪	许佳琪	0
陈道明老师发福了	陈道明	1
金子涵有点AOA雪炫是感觉	aoa	0
哈哈哈哈哈哈哈我才反应过来！林宥嘉目前唱邓紫棋还好哈哈哈	林宥嘉	0
许杨玉琢那么拽干嘛	许杨玉琢	-1
葛鑫怡加油!	葛鑫怡	1
金子涵跳舞不赖啊	金子涵	1
刘令姿能把这种小老头背心穿得好高大上	刘令姿	0
汪睿宝宝不哭心疼	汪睿	1
金子涵金子涵金子涵	金子涵	0
QQ配张伟真厉害	张伟	0
葛鑫怡冲冲冲	葛鑫怡	1
亮点是这是邓紫棋自己词曲演唱的歌（曲是合作	邓紫棋	0
喻言喻言啊啊啊啊	喻言	1
安崎和上官气场太强了	上官	1
王牌对王牌第5季:沈腾贾玲模仿甜蜜蜜坐垮自行车华晨宇杨迪还原年画娃娃	华晨宇	0
戴燕妮和蔡卓宜是同一批粉丝吗哈哈哈哈哈哈哈哈	戴燕妮	0
牧尘演技一流	牧尘	1
王新宇太油腻了	王新宇	-1
安琪很自信，从她的身体仪态看	安琪	1
好讨厌这个白幼宁	白幼宁	-1
邓紫棋算了吧	邓紫棋	-1
上官喜爱冲冲冲	上官喜爱	1
笑起来的声音像徐峥呀	徐峥	0
哪吒娘福气那么早就可以吃好多棒棒糖了。丶	哪吒	0
长得有点像王源？	王源	0
七穗参加过《这样唱好美》陈立农是里面的评委	陈立农	0
毛毛的歌能听到老	毛毛	1
许佳琪太一般了，跳的好僵硬，没有美感	许佳琪	-1
华晨宇我来了	华晨宇	0
申公豹你从开局就出场了你还要等到啥时候😡😡😡😡😡😡😡😡😡😡😡😡😡😡😡	申公豹	0
我现在才发现吕子乔换智能手机了！	吕子乔	0
申公豹你下次点个头就行了	申公豹	0
看到了看到了你叫王清！！	王清	0
安崎!!!!!!!	安崎	1
你只抓住了申冰的眼球抓不住Lisa的眼球啊	lisa	0
安娜怎么那么小就长痘痘了？	安娜	0
get不到蔡卓宜，感觉满脸玻尿酸	蔡卓宜	-1
不是每个陈念都有小北	小北	0
肖战你妈啊，真是服了，嫌他糊的不够快就上别地黑去，ky你妈啊一天天的	肖战	-1
听说朱元璋喜欢杀人	朱元璋	0
求求大家捞一下魏辰妹妹吧求求大家捞一下魏辰妹妹吧求求大家捞一下魏辰妹妹吧求求大家捞一下魏辰妹妹吧	魏辰	0
刘雨昕刘雨昕好可爱哈哈哈	刘雨昕	1
戴燕妮真的很棒	戴燕妮	1
林小宅令人意外的努力，好感上升很多	林小宅	1
孔雪儿人品不行.看不下去	孔雪儿	-1
安崎我爱你！！！！！！	安崎	1
哪吒血亲只有敖丙	敖丙	0
我服了一到孔雪儿就刷屏拜托键盘侠们先做人好吗	孔雪儿	0
这是我目前最喜欢的3A，加上王总四个A，出除孙雪儿的A不喜欢，其他都好喜欢加油！	孙雪儿	0
这组我只记得许杨玉琢	许杨玉琢	0
黄小芸像王源	黄小芸	0
陈品瑄更抓眼	陈品瑄	1
刘雨昕业务能力才是最强的请看街舞2	刘雨昕	1
四个姐妹中申洁还好	申洁	1
小北看到小孩子被逼迫偷钱就打了那些混混结了怨，小北是善良的人	小北	1
申公豹你不能这样，看我今天我不打死你。申公豹你等着瞧😡😡😡	申公豹	0
白真的好讨厌，在这个剧里	白	-1
nice，不过剪辑师让我想起那英的那那件事！剪辑师很商量，台下观看的小姐姐也都很善良！～(￣▽￣～)	那英	0
黄小芸最棒继续加油加油	黄小芸	1
马上去给徐紫茵投2票	徐紫茵	1
莫非是叶凡在渡劫，天庭显现了	莫非	0
徐轸轸妹子一直在鼓励渲真的很善良	徐轸轸	1
蔡徐坤个人意见太多	蔡徐坤	-1
戴燕妮戴燕妮戴燕妮戴燕妮戴燕妮戴燕妮戴燕妮戴燕妮冲	戴燕妮	1
魏辰啊啊啊啊啊啊啊啊	魏辰	1
呜呜呜呜牧尘也太会了吧	牧尘	0
后面还有李现么？	李现	0
不会看演员表么，易烊千玺	易烊千玺	0
赵小棠吸血进前三了好狠	赵小棠	-1
魏辰给我冲！！！	魏辰	1
是是是林俊杰天下无敌谁说比他强都要抓走	林俊杰	0
陈珏小宝贝我来了啊啊啊啊啊啊啊啊啊啊啊啊啊啊啊啊啊啊啊啊啊啊啊啊啊啊啊啊啊啊啊啊啊啊啊啊啊啊啊啊啊啊啊啊啊啊啊啊啊啊啊啊啊啊啊啊啊啊啊啊啊啊	陈珏	1
魏辰怎么都没镜头	魏辰	0
陈萍萍是范的外公	陈萍萍	0
啊啊啊啊啊安崎杀我！救命！	安崎	0
虞书欣蔡卓宜陈珏给👴冲	蔡卓宜	1
嘴型说的乔楚生啊啊啊啊啊啊啊啊啊啊啊啊啊啊啊啊啊！！！！！！！！！！！！！！！！！！！！！！！！！	乔楚生	0
温宁思追有了，聂明玦聂怀桑有了，是不是还要来金陵江澄	聂明玦	0
沈腾以5G的速度接收信息，谢广坤以1Ｇ的速度接收，差距就是这么大	谢广坤	0
孔雪儿旁边的女生头发都p发光了	孔雪儿	0
男生都喜欢谢可寅	谢可寅	1
李沁就该演李云瑞	李沁	0
牧尘哥哥的灵阵手	牧尘	0
为什么王承渲才77票？怎么可能	王承渲	0
王俊凯个锤子，这是王源	王俊凯	0
最恶心就算沈腾了假作	沈腾	-1
你们在孔雪儿那也没要求唱功啊？	孔雪儿	0
能选五月天起码品味不错，不过感觉还是只有阿信唱得有味道	五月天	1
毛毛还没上的时候黄霄雲就说了不论下一个是谁都要推	毛毛	0
王欣宇冲啊！！！	王欣宇	1
华晨宇！华晨宇！华晨宇！！	华晨宇	0
蔡卓宜太甜啦！	蔡卓宜	1
求求大家捞一下魏辰妹妹吧求求大家捞一下魏辰妹妹吧求求大家捞一下魏辰妹妹吧求求大家捞一下魏辰妹妹吧	魏辰	0
她不配和程潇比较	程潇	0
哈哈开始担心以后了，王总知道以后投票投不过别人会被刷下来，哈哈哈	王总	0
柳岩她爸姓朱	柳岩	0
孔雪儿整容太明显	孔雪儿	-1
林宥嘉和邓紫棋在节目里永远躲不开彼此的歌	林宥嘉	0
文哲温柔又强大啊	文哲	1
想起威基基里的瑞贝卡	威基	0
是不是聂风的血饮刀	聂风	0
王承渲，加油，不管是不是C位，我们给你投票，C位不要就不要了	王承渲	1
孔雪儿给我的第一印象不怎么好，(别喷，别杠)	孔雪儿	-1
王承渲给我冲啊，	王承渲	1
任达华和徐锦江友情出演	徐锦江	0
蔡卓宜的颜真的戳我心窝了	蔡卓宜	1
这部剧什么时候郭德纲赵本山成龙周润发刘德华他们出来，就为了看他们。。。。。。。。。。。。。。。。。	刘德华	0
你们这上一个小屁孩没有没了的说那个哪吒那个哪吒保护	哪吒	0
李小冉真不适合古装啊	李小冉	0
金子涵居然能第二	金子涵	0
蔡卓宜虽然实力不高，但是是真的好看，所以我觉得观众投票是看脸的	蔡卓宜	0
安崎有种反差萌哈哈哈哈哈	安崎	1
我还让了你一只手哪吒	哪吒	0
唉牧尘还帮慕白找老师	牧尘	0
王承渲你很棒了，比冰清玉洁好多了，冰清玉洁就算有笑容也差得很多	冰清玉洁	-1
不喜欢秦牛正威	秦牛正威	-1
这个冰清玉洁真的是脑子有病还是什么自己没有私信呵呵是个人都能看出来明明是王承渲跳的比较好	冰清玉洁	-1
袁娅维那么好的嗓子选了一首那么普通的歌。真浪费了这次机会	袁娅维	1
还好陈品瑄也可以	陈品瑄	1
啊啊啊啊啊啊啊啊刘雨昕	刘雨昕	1
有一说一，人品不了解，但孔雪儿跳的真的还不错	孔雪儿	1
为什么哪吒一出就长牙了	哪吒	0
蔡徐坤表情没反应哈哈哈哈，看来还得用实力打动他	蔡徐坤	0
之前还挺喜欢柳慕白，当他说完这句话顺间气就上来了	柳慕白	1
沈腾眉毛挑的好像郭达	郭达	0
我想看长大的不失去意识的哪吒和人形的敖丙同框	哪吒	0
白真过分，TMD	白真	-1
啊啊啊啊啊许佳琪！	许佳琪	1
孔雪儿本来就是首A啊	孔雪儿	0
陈念632不是随便考吗	陈念	0
魏辰魏辰魏辰魏辰魏辰————！！！！！	魏辰	0
不比孔雪儿好？、	孔雪儿	-1
坤哥哈哈哈哈哈净说大实话	坤哥	0
青1来的，许佳琪小姐姐粉了❤️	许佳琪	1
这是长公主！！？？我看是白骨精	白骨精	0
谢可寅第13名啦，加油	谢可寅	1
王承渲好好看	王承渲	1
许佳琪！加油加油！	许佳琪	1
徐紫茵爱了爱了	徐紫茵	1
金子涵真的长得太好看了	金子涵	1
假如把杨迪换成肖战，肖战答对，他都听得见，肖战以后都别来了，玩赖的玩意	肖战	-1
虞书欣虞书欣加油虞书欣虞书欣加油虞书欣虞书欣加油	虞书欣	1
葛鑫怡冲冲冲！	葛鑫怡	1
薛之谦，邓紫棋	邓紫棋	0
戴燕妮！！！！	戴燕妮	0
留名被易烊千玺演技折服的女人	易烊千玺	0
哪吒大招可以啊	哪吒	1
王承渲冲冲冲	王承渲	1
这么多咋真好玩？这哪吒真好玩	哪吒	1
哪吒你在哪个世界	哪吒	0
不喜欢王新宇	王新宇	-1
超喜欢孔雪儿！！！爱了爱了！！！	孔雪儿	1
莎莎我怕怕～	莎莎	0
孔雪儿是个什么鬼	孔雪儿	-1
申冰:我当小三绝对没有私心的，我觉得我能胜任小三这个位置	申冰	-1
刘令姿哈哈哈哈不愧是你	刘令姿	1
我龙哥最帅，最爱张云龙！	龙哥	1
现实中有太多的陈念，可是却没有小北，😭😭😭😭	陈念	0
孔雪儿啊啊啊啊啊啊啊啊啊啊	孔雪儿	1
段小薇一边去	段小薇	-1
awsl，许佳琪太可了！	许佳琪	1
华晨宇华晨宇华晨宇	华晨宇	0
虞书欣麻麻爱你。💜虞书欣冲冲冲！！！虞书欣麻麻爱你。💜虞书欣冲冲冲！！！虞书欣麻麻爱你。💜虞书欣冲冲冲！！！虞书欣麻麻爱你。💜	虞书欣	1
她好像包贝尔老婆(͡°͜ʖ͡°)✧	包贝尔	0
赵雪爱蔡徐坤	蔡徐坤	0
刘亚楠，刘亚楠，刘亚楠	刘亚楠	0
还是杨颖最好看	杨颖	1
左卓左卓左卓冲啊	左卓	1
佳琪古装也超好看的	佳琪	1
对蔡徐坤改变好大，路转粉了谢谢	蔡徐坤	1
这个节目唯一的败笔就是贾玲	贾玲	-1
吊打孔雪儿好吗	孔雪儿	-1
大哪吒：我命由我不由天	大哪吒	0
这时候的哪吒好丑啊	哪吒	-1
徐紫茵徐紫茵	徐紫茵	0
能不能别给孔雪儿这个贱人镜头	孔雪儿	-1
蔡有点神似沈梦辰	沈梦辰	0
孔雪儿不行啊	孔雪儿	-1
牧尘的同学好几个都不怀好意	牧尘	0
虞书欣加油！😘	虞书欣	1
金子涵金子涵金子涵金子涵金子涵	金子涵	0
李沁就该演李云瑞	李云瑞	0
林小宅加油啊	林小宅	1
莎莎肯定在舞台上说不出来啊	莎莎	0
长腿大美女金子涵	金子涵	1
评论的眉孔雪儿的实力都给我闭嘴吧一群八婆叨叨啥呢	孔雪儿	0
宋昕冉下周见	宋昕冉	0
OMG孔雪儿真的不是我pick的颜	孔雪儿	0
许佳琪我爱你啊啊啊啊啊啊啊啊啊啊啊啊啊啊啊啊啊啊	许佳琪	1
我放心了，哈哈哈哈哈，王承渲，徐轸轸。还有那个小姐姐，我送你们出道	王承渲	1
我比哪吒小呀	哪吒	0
你是我的好朋友，哪吒	哪吒	1
把Lisa称之为别人？她可是你们的导师诶，真没礼貌😒😕	lisa	0
陈珏，陈珏，陈珏	陈珏	0
王承渲应该站C位，她跳舞那么好	王承渲	1
王承渲加油！	王承渲	1
王菲来的理你	王菲	0
长公主这是得罪造型师了	长公主	0
要是没有路垚乔楚生一个案也破不出来还探长呢剧情需要	探长	0
葛鑫怡葛鑫怡葛鑫怡葛鑫怡葛鑫怡葛鑫怡	葛鑫怡	0
蔡徐坤蔡徐坤蔡徐坤蔡徐坤蔡徐坤蔡徐坤蔡徐坤蔡徐坤蔡徐坤蔡徐坤蔡徐坤蔡徐坤蔡徐坤蔡徐坤蔡徐坤蔡徐坤蔡徐坤蔡徐坤蔡徐坤蔡徐坤	蔡徐坤	0
杨迪太吓人了，这身儿。	杨迪	-1
金子涵金子涵，金子涵金子涵。冲啊	金子涵	1
曹贵修还是蛮男人的	曹贵修	1
昨儿个还想伤害牧尘呢今儿个今请喜酒了？	牧尘	0
王承渲！王承渲！王承渲！	王承渲	0
孔雪儿也不知道花了多少钱	孔雪儿	0
曾可妮妈妈爱你！	曾可妮	1
徐紫茵好美，又有实力	徐紫茵	1
我觉得孔雪儿很棒啊	孔雪儿	1
花花周深都是宝藏男孩	花花	1
哪吒什么时候变帅	哪吒	0
魏辰妈妈爱你(ɔˆ³(ˆ⌣ˆc)	魏辰	1
坤哥和莎莎有一个镜头都没笑，表情也很牵强哈哈哈哈哈哈	坤哥	0
怎么还不来救欧豪	欧豪	0
当然得是乔楚生	乔楚生	0
这哪吒和敖丙就是鸣人和佐助的影子，剧情和中心思想也来自火影忍者	鸣人	0
前面说看虞书欣想吐的你是怀孕了吗🙄	虞书欣	0
要是没有路垚乔楚生一个案也破不出来还探长呢剧情需要	路垚	1
张涵予就适合演硬汉带安全感的角色	张涵予	1
我等虞书欣等的头发都白了	虞书欣	1
陈念的女朋友是谁	陈念	0
前面说刘昊然的刘昊然在哪？你给我圈出来看看	刘昊然	0
林小宅冲冲冲	林小宅	1
莎莎你控制一下！	莎莎	0
说商菊贞的怕是傻子吧！侯玉魁都说了当时是和商菊贞，宁九郎，姜荣寿同台的时候偷听到的。	商菊贞	0
谁说薛之谦不配	薛之谦	0
魏辰魏辰魏辰	魏辰	0
白幼宁脖子上有草莓	白幼宁	0
还在毛毛那歌的情绪里	毛毛	0
小北:你保护世界，我保护你	小北	0
反而王承渲更像c位	王承渲	1
快乐，我最喜欢的就是这组的第一第二欸，我喜欢金子涵与安琦	安琦	1
我终于忍不住要吐槽了陈美嘉和胡一菲整了容后没有前四部好看真可笑没整漂亮反而错了没了汪远还真不行	陈美嘉	-1
哇这个蔡卓宜好好看啊妈妈呀	蔡卓宜	1
混天绫，火尖枪嗨氏哪吒的专配！	混天绫	0
给赵小棠来一票	赵小棠	1
啊啊啊谢可寅刘雨昕！！！	谢可寅	1
欢迎密码，你用心，你敏敏婆，魔攻，神龙龙大哪吒，小哪吒，刚生出来的小哪吒，奥比太乙真人。	太乙真人	0
一百遍刘令姿我可以	刘令姿	1
光头哪吒来砍树，熊大熊二来阻止。	熊二	0
孔雪儿最强孔雪儿最强孔雪儿最强孔雪儿最强孔雪儿最强孔雪儿最强	孔雪儿	1
牧尘哥哥太善良了	牧尘	1
魏辰魏辰魏辰魏辰魏辰魏辰魏辰魏辰魏辰！	魏辰魏辰	0
突然想到尤长靖！	尤长靖	0
好好看节目，别cue王源	王源	0
徐轸轸徐轸轸徐轸轸	徐轸轸	0
别酸了，人家就是好，我一个路人都感觉雪儿厉害	雪儿	1
说柳岩的请问你去过祖安大舞台么？柳岩吃你家大米了？	柳岩	0
杨迪给腾哥揉腿那下好暖	杨迪	1
像张一山的声音	张一山	0
魏辰那个麦哈哈哈哈哈哈哈哈哈	魏辰	0
不喜欢有杨迪	杨迪	-1
安崎和蔡卓宜的不同就在于有颜值靠颜值没颜值看实力	蔡卓宜	0
申公豹这个骗子。	申公豹	0
坤哥都看不下去了	坤哥	0
因为白幼宁我弃剧了	白幼宁	-1
有点像沈梦辰和林志颖的合体	林志颖	0
孔雪儿有觉醒好吗。。	孔雪儿	0
哈哈哈哈哈哈哈我才反应过来！林宥嘉目前唱邓紫棋还好哈哈哈	邓紫棋	0
白幼宁太自私了，开玩笑也没个限度	白幼宁	-1
让申洁来抓我眼球吧，我就不信她能抓的到。	申洁	-1
珍妃有小孩吗	珍妃	0
王承渲应该是C位	王承渲	1
是爱坤就给谢可寅助力，谢谢你们	谢可寅	1
恕我直言真的难看这个哪吒	哪吒	-1
欧若拉给我冲	欧若拉	1
下一季艾莎变成了自然之灵，保护大家	艾莎	0
虞书欣一点也不好，他就是个傻逼	虞书欣	-1
黄欣苑镜头太少了，表白金子涵啊啊啊	金子涵	1
金子涵金子涵金子涵	金子涵	0
孔雪儿孔雪儿孔雪儿孔雪儿孔雪儿	孔雪儿	0
周深和毛毛真的爱了	周深	1
林小宅衣服不好看	林小宅	-1
申洁长得正常一点其他三个太丑了	申洁长	0
孔雪儿玩过坤的梗	孔雪儿	0
小北真的爱惨了这个女孩	小北	0
范闲的眼睛看着真难受啊	范闲	0
刘柏辛说不奇袭袁娅维，怕伤袁娅维的心……我的天那，没事的，奇袭袁娅维吧😕	袁娅维	0
孔雪儿赶紧滚蛋吧	孔雪儿	-1
杨迪是凭实力火的不然为什么娜姐会捧他那么多导演找他拍戏呢	娜姐	0
孔雪儿一脸输不起的样子	孔雪儿	-1
张伟是用离合开的吧	张伟	0
发现黑料不真，粉丝不是买的之后，对孔雪儿改观，居然还有点期待她的实力	孔雪儿	1
许佳琪可以c位！	许佳琪	1
杨迪的耳机没声音听得见。	杨迪	0
孔雪儿真的恶心	孔雪儿	-1
确实海王是到花果山找孙悟空学了棍法	孙悟空	0
太讨厌杨迪。	杨迪	-1
许杨玉琢好酷	许杨玉琢	1
丑逼安琪滚丑逼安琪滚丑逼安琪滚丑逼安琪滚丑逼安琪滚丑逼安琪滚丑逼安琪滚丑逼安琪滚丑逼安琪滚	安琪	-1
许佳琪许佳琪许佳琪许佳琪许佳琪许佳琪许佳琪许佳琪许佳琪许佳琪	许佳琪	0
刘令姿有点可	刘令姿	1
蕊蕊开心了二爷也笑了	蕊蕊	1
孔雪儿谢可寅冲冲冲	谢可寅	0
佳琪自信点，加油！！	佳琪	1
林小宅抄袭狗	林小宅	-1
有点像徐怀钰的感觉	徐怀钰	0
王承渲名副其实第一好吗？？？	王承渲	1
戴燕妮入股不亏！	戴燕妮	1
四字弟弟好吧，怎么变王俊凯了	四字弟弟	0
申洁：我觉得我的腿比她的腿粗，长的也没她好看，	申洁	0
第一，花花，第二应该是米希牙，第三有雨神，不喜欢周深的声音	米希	0
抄袭大王何美延	何美延	-1
这次是剪辑的锅，不是孔雪儿举手的	孔雪儿	0
王承渲你很棒！我很喜欢你	王承渲	1
蔡卓宜第一？？	蔡卓宜	-1
安琪的媒婆痣看着好难受啊	安琪	-1
我终于忍不住要吐槽了陈美嘉和胡一菲整了容后没有前四部好看真可笑没整漂亮反而错了没了汪远还真不行	汪远	0
上官喜爱、安崎和许佳琪是真的可以Ａ	安崎	1
王承渲！王承渲！王承渲！	王承渲	0
杨紫能跟李沁比？杨紫多丑没点数？	杨紫	-1
刘令姿真的超模脸的感觉	刘令姿	1
申公豹臭的连说话都说不好了。	申公豹	0
蔡徐坤你要笑死我	蔡徐坤	1
上快本的应该都是A，所以安崎和上官都是A所以，，为毛说孔雪儿是首A	安崎	0
金子涵金子涵金子涵金子涵金子涵金子涵金子涵金子涵冲鸭	金子涵	1
戴燕妮姐姐冲冲冲冲冲冲	戴燕妮	0
我想看长大的不失去意识的哪吒和人形的敖丙同框	敖丙	0
长公主是二皇子的	二皇子	0
刘雨昕高位出道	刘雨昕	1
顺间觉得哪吒好可怜	顺间	0
毛毛刚才笑的时候嘴巴是个心的形状	毛毛	0
葛鑫怡冲冲冲	葛鑫怡	0
哪吒怎么可以la么可耐	哪吒	1
安崎小姐姐好可爱	安崎	1
杨迪看着特别讨厌，反感	杨迪	-1
艾玛这渲被欺负了吧气人	艾玛	0
什么时候到虞书欣啊	虞书欣	0
孔雪儿我死了	孔雪儿	0
喻言粉定了！！！	喻言粉	1
蔡徐坤，你是来搞笑的吗？￼	蔡徐坤	0
葛鑫怡加油！！	葛鑫怡	1
感觉许佳琪比孔雪儿好一点	许佳琪	1
丑萌丑萌的哪吒	哪吒	0
王承渲真的好好看啊好嫩	王承渲	1
刷蔡卓宜的是水军么，这业务能力不行…镜头还那么多	蔡卓宜	-1
告诉你们华晨宇没有彩排就上场了哦	华晨宇	0
蕊蕊会不会就是丢失的阿哥	蕊蕊	0
浪里小白龙吕子乔	吕子乔	0
胡小蝶是不是参加过舞蹈风暴里的那个？	胡小蝶	0
白幼宁真是够了	白幼宁	-1
戴燕妮A班镜头这么少太惨了吧	戴燕妮	0
对不起毛毛的粉丝们我站一秒他俩	毛毛	0
是王迅配的音吗	王迅	0
徐紫茵真d有实力	徐紫茵	1
为什么我的眼里只能看见蔡卓宜	蔡卓宜	1
就郑易一个明白人	郑易	0
煞笔肖战粉，你们还敢刷吗，肖战是我儿	肖战	-1
想什么呢谁给你的自信，不喜欢申洁	申洁	-1
毛毛应该来首东北民谣，那首歌能打	毛毛	0
感觉孔雪儿镜头好少	孔雪儿	0
陈珏什么时候出场啊？	陈珏	0
蔡卓宜冲啊！！！！	蔡卓宜	1
虞书欣好讨厌	虞书欣	-1
牧尘太义气了	牧尘	1
孔雪儿！！！！！！！	孔雪儿	0
宋江，你都学会开飞机了，其他弟兄都在干嘛啊？？	宋江	0
金子涵真的是颜值和实力具备	金子涵	1
刘令姿刘令姿刘令姿刘令姿刘令姿刘令姿刘令姿刘令姿	刘令姿	0
刘令姿长在我审美上了	刘令姿	1
《潮流合伙人》下期才有王源！！！《潮流合伙人》下期才有源儿！！！	王源	0
虞书欣蔡卓宜陈珏给👴冲	陈珏	1
蔡卓宜跟不上拍，看懂了吗？？	蔡卓宜	-1
孔雪儿真的好像杨幂。。。。。	孔雪儿	0
金子涵加油！！！！	金子涵	1
为啥熬丙比哪吒还高！	哪吒	0
我看哪吒之魔同	哪吒	0
安崎太杀我了！啊啊啊，我好爱😍😍😍	安崎	1
黄欣苑加油啊	黄欣苑	1
喻言妈妈爱你！	喻言	1
王承渲没关系，加油，你很棒的	王承渲	1
长公主和公主不一样的	长公主	0
欢迎密码，你用心，你敏敏婆，魔攻，神龙龙大哪吒，小哪吒，刚生出来的小哪吒，奥比太乙真人。	哪吒	0
留个名，李帅	李帅。	0
张新成！！！！！！！！！！！！！！！！！！！！！！！！！！！！	张新成	1
王承渲真的好乖呜呜	王承渲	1
蔡徐坤说的对。好帅。	蔡徐坤	1
快反抗啊陈念	陈念	0
许佳琪加油(ง•̀_•́)ง	许佳琪	1
牧尘别听他的。	牧尘	0
陈珏有点像Yamy	yamy	0
为什么魏晨金子涵镜头这么少	金子涵	0
申公豹又结巴	申公豹	0
申冰退赛了姐妹们！！！	申冰	0
金子涵给我站直	金子涵	1
我觉得孔雪儿唱功不好怎么就拿A了	孔雪儿	-1
小说里的牧尘可没这么傻逼	牧尘	0
刘令姿好高哈哈哈哈	刘令姿	1
战歌起，伍佰可能会迟到，但绝对不会缺席。	伍佰	0
感觉是个脑残的憨批虞书欣	虞书欣	-1
孔雪儿是有后台吗？	孔雪儿	0
徐紫茵谢可寅许馨文都是下一站传奇的宝藏妹妹！！！！	下一站传奇	0
孔雪儿最强孔雪儿最强孔雪儿最强孔雪儿最强孔雪儿最强孔雪儿最强	孔雪儿	1
金子涵太好看了吧	金子涵	1
金子涵冲鸭!	金子涵	1
林小宅冲鸭！！！	林小宅	1
现实中周冬雨才是女痞	周冬雨	-1
林俊杰会不会来	林俊杰	0
混天绫，火尖枪嗨氏哪吒的专配！	嗨氏	0
萧敬腾杨坤羽泉张杰都是最美和声的导师！	杨坤	0
为了许佳琪追了一部综艺	许佳琪	1
孙芮别紧张，加油	孙芮	1
托马斯全旋厉害了	托马斯	0
孔雪儿没人格魅力	孔雪儿	-1
在小红书上的安娜就是我。	小红书	0
王清就是小汤唯啊	王清就	0
柳幕白好像程七七	程七七	0
敖丙:哪吒你多少注意下我的感受😂😂😂	哪吒	0
孔雪儿不开心了	孔雪儿	0
许佳琪，许佳琪上PK一下PK一下，许佳琪，许佳琪	许佳琪	0
易烊千玺，我爱死你啦	易烊千玺	1
申洁为什么第二？？？？？？？？？？	申洁	-1
那他就是王源喽	王源	0
小鱼儿出谷了	小鱼儿	0
我觉得蔡徐坤这波让我很喜欢哎哈哈哈哈，这孩子挺不错的	蔡徐坤	1
七穗参加过《这样唱好美》陈立农是里面的评委	这样唱好美	0
孔雪儿你还能再丑点吧	孔雪儿	-1
我感觉许佳琪不错喜欢她	许佳琪	1
蔡徐坤真的很委婉了	蔡徐坤	0
徐锦江演技不错！！！	徐锦江	1
上官喜爱真得很有实力很强	上官喜爱	1
他妈逼的这个陈美嘉真的是成事不足败事有余	陈美嘉	-1
黄小芸像王源	王源	0
我坤哥说的太好了	坤哥	1
王俊凯个锤子，这是王源	王源	0
我超级喜欢袁娅维的声音	袁娅维	1
哎王思予呢想看实力强的	王思予	0
许佳琪是清妃吗	清妃	0
陈珏、陆柯燃、王清，给我冲	陆柯燃	1
孔雪儿嘴好丑	孔雪儿	-1
说骂肖战的出去的，这里没有肖战，要出也是你们出去	肖战	0
太乙你救了我一命哪吒：太乙你救了我一命	太乙	0
张杰和她谁是原唱	张杰	0
孔雪儿嘴好丑	孔雪儿	-1
感觉文哲有点像金所炫超好看	金所炫	1
韩雪够作了吧	韩雪	-1
魏辰啊啊啊啊yg的必须强	魏辰	1
给刘雨昕投票啊	刘雨昕	1
申冰给老子爬	申冰	0
葛鑫怡葛鑫怡	葛鑫怡	0
最爱的三个歌手都来了，深深，花花，毛毛	花花	1
哪吒被乾坤圈压制了	哪吒	0
光头哪吒来砍树，熊大熊二来阻止。	熊大	0
刷秦牛的傻逼吗，认错人了不知道吗？秦牛正威还没出来	秦牛	0
啊啊啊啊安崎	安崎	1
欧豪后来可期	可期	1
蔡徐坤啊啊啊啊	蔡徐坤	1
走的韩国风，哎。权志龙	权志龙	0
何美延抄袭狗	何美延	-1
张总唱功比小王好	小王	-1
蔡卓宜冲冲冲！！！！	蔡卓宜	1
申洁到后面其实越来越不自信了	申洁	0
瑞贝卡？？？	瑞贝卡	0
孔雪儿跳舞不惊艳只是中规中矩	孔雪儿	0
woc，看到sb何美延了，恶心	何美延	-1
葛鑫怡我爱你	葛鑫怡	1
想到了尤长靖	尤长靖	0
蔡卓宜拿的是不是ycy的剧本？	蔡卓宜	0
-1乐华】🍓-1宋昭艺】🍒𝙋𝙄𝘾𝙆宋昭艺入股不亏🍒	宋昭艺	1
还是换张艺兴来吧	张艺兴	0
蔡卓宜真的没实力	蔡卓宜	-1
孔雪儿我来了!	孔雪儿	1
戴燕妮谢可寅刘雨昕黄小芸金子涵刘亚楠王承渲安崎赵小棠	刘亚楠	0
演技太好了吧周冬雨	周冬雨	1
虞书欣怎么还没来呀	虞书欣	0
这不是易烊千玺吗	易烊千玺	0
这哪吒和敖丙就是鸣人和佐助的影子，剧情和中心思想也来自火影忍者	敖丙	0
徐紫茵和刘亚楠我都喜欢wuwu	刘亚楠我	1
不喜欢白幼宁	白幼宁	-1
安崎加油哦！！！plmm们一起冲冲冲！！！	安崎	1
许佳琪你最棒	许佳琪	1
刘令姿颜真的杀我用精致来形容	刘令姿	1
金子涵金子涵	金子涵	0
费费是沈涛的老婆吧？	沈涛	0
光头哪吒来砍树，熊大熊二来阻止。	哪吒	0
马蜀君加油加油	马蜀君	1
蔡徐坤长得丑整容怪！唱歌不好听！没实力！当啥导师？	蔡徐坤	-1
蔡卓宜小甜心啊啊啊啊啊啊	蔡卓宜	1
为什么不让徐锦江来演？	徐锦江	0
所以两个人都获罪小北能判轻一点吗	小北	0
文哲好像颖儿	文哲	0
申洁本来就不咋样，三个姐姐更是推着害她	申洁	-1
喻言喻言王者归来	喻言	1
王源，范世琦，贾乃亮保护我	王源	0
说是王源的哪个能不能认真点	王源	0
长公主得罪定型师了吧。。。。。。。。	长公主	0
哪吒先在liao拐弯就在你心里那个美队了……	哪吒	0
刘雨昕别这样快跟我回家	刘雨昕	0
你一票我一票明天蔡卓宜就出道	蔡卓宜	0
有没有觉得她很像金锁时期的范冰冰	没有	0
杨迪是不是没音乐，别人的声音都能听到😂😂😂	杨迪	0
蔡卓宜别笑了，我要融化了啊啊啊啊啊啊啊	蔡卓宜	1
陈珏陈珏陈珏	陈珏	0
黄欣苑镜头好少	黄欣苑	0
魏辰只有一句字幕，真的是。。	魏辰	0
一博是美岐的，肖战滚蛋	肖战	-1
蔡卓妍像个花瓶	蔡卓妍	-1
白幼宁在这部剧里真的不合适，差点都弃剧了，（个人想法勿喷）	白幼宁	-1
徐紫茵演过老师好和大宋少年志一个跑龙套的	大宋少年志	0
陈珏、陆柯燃、王清，给我冲	陈珏	1
就要投蔡卓宜，离过婚怎么了，看实力还是看婚姻史？	蔡卓宜	1
蔡有点神似沈梦辰	蔡有点	0
蔡卓宜太甜了吧	蔡卓宜	1
无语虞书欣和蔡卓宜，除了人气一点实力都没有，凭啥前十	蔡卓宜	-1
王承渲加油啊，你很棒的！！	王承渲	1
高晓松太油腻了	高晓松	-1
拉子姐是薛之谦附体了吗	拉子姐	0
韩雪看起来真傻	韩雪	0
金子涵太像miss了呜呜呜呜	金子涵	0
魏辰加油啊，希望魏辰有镜头，多一点	魏辰	1
刘令姿不会笑因为她笑不好看	刘令姿	-1
艾莎不管吗？😥	艾莎	0
安崎妈妈来啦	安崎	1
蔡徐坤好温柔	蔡徐坤	1
葛鑫怡很美啊	葛鑫怡	1
为什么魏晨金子涵镜头这么少	魏晨	0
许佳琪棒棒棒！	许佳琪	1
喻言喻言王者归来	喻言	1
这特效，我欠哪吒一张电影票	哪吒	0
刘令姿！！！天鹅姐姐冲啊！！	刘令姿	1
又来一个唐小米	唐小米	0
言冰云是肖战	肖战	0
为什么虞书欣都没有表演过就第一，还有镜头，实力都没看到，这对别人好像有点不公平吧，砸钱了???	虞书欣	-1
周深周深和毛毛好甜啊啊啊啊	周深	1
蔡卓宜初吻没了，还有结过婚，不是处	蔡卓宜	-1
韩雪真能装，呸呸呸	韩雪	-1
我要看喻言出道！！！	喻言	1
这tn是易烊千玺	易烊千玺	0
许佳琪许佳琪许佳琪许佳琪许佳琪许佳琪许佳琪许佳琪许佳琪许佳琪许佳琪许佳琪许佳琪许佳琪许佳许佳琪许佳琪	许佳琪	0
喻言终于！！！	喻言	0
匠星那俩出不了道都懂，但前期太恶心死丑逼安琪丑逼喜爱滚，辣眼睛	安琪	-1
《潮流合伙人》下期才有王源！！！《潮流合伙人》下期才有源儿！！！	潮流合伙人	0
牧尘好聪明啊！牧尘主意好多好多。	牧尘	1
许杨玉琢的镜头呢？	许杨玉琢	0
丽萨不在电台工作，怎么看的曾小贤	曾小贤	0
曾可妮妈妈来了！	曾可妮	1
南江米娅视觉花钱了	米娅	0
哈哈哈哈哈哈哈孔雪儿	孔雪儿	0
哈哈哈哈哈可爱了小棠	小棠	1
有毛病吧孔雪儿	孔雪儿	-1
夜华你妈买批死妈死全家	夜华	-1
安崎气场绝了	安崎	1
申冰已经不配有名字了	申冰	-1
所以我给张伟打了60分	张伟	1
蔡卓宜加油吖蔡卓宜加油吖蔡卓宜加油吖	蔡卓宜	1
喻言出道吧啊啊啊啊	喻言	1
看到关晓彤很讨厌	关晓彤	-1
说王源的真的无语	王源	0
留个名蔡徐坤	蔡徐坤	0
安崎和上官气场太强了	安崎	1
虞书欣我挺你	虞书欣	1
王思予镜头呢！！？	王思予	0
蔡徐坤太棒了吧	蔡徐坤	1
李小冉这发型丑爆了	李小冉	-1
果然，早年你就算买不起西装还这么爱穿，吕子乔	吕子乔	0
这不比孔雪儿强吗	孔雪儿	-1
刘令姿冲啊！！！！！	刘令姿	1
金子涵小姐姐好漂亮啊	金子涵	1
很早以前就不喜欢孔雪儿，时间长了都忘了为什么不喜欢	孔雪儿	-1
冰清玉洁真是够了，玷污了这四个字，我觉得Lisa说的没错，王承渲更适合C位	冰清玉洁	-1
此剧郑毓芝老师跟许还山老师分别以83岁82岁高龄出演确实令人敬佩！	许还山	1
安崎绝了高位出道吧！	安崎	1
许佳琪冲冲冲	许佳琪	1
王清好喜欢你啊	王清好	1
申冰这声音也太作了吧，恶心，嘤嘤嘤怪	申冰	-1
哪吒一拳就把石头打碎了。	哪吒	0
蔡徐坤我来了	蔡徐坤	0
啊啊啊啊韩东终于有镜头了！	韩东	1
一群假粉丝海王俊凯，这明明是易烊千玺	易烊千玺	0
王心铭和王承渲好像啊是姐妹吗	王心铭	0
谢可寅啊啊啊啊啊	谢可寅	1
陆柯燃陆柯燃陆柯燃陆柯燃	陆柯燃	0
天啊韩东终于有镜头了！！！	韩东	1
前面说林俊杰感觉的别走，等等我	林俊杰	0
我喜欢上安崎了	安崎	1
薛之谦这垃圾货怎么还有人提	薛之谦	-1
上官喜爱啊啊：别让我逮到舞台，我会把它咬碎	上官喜爱	0
宋江开飞机了	宋江	0
温宁思追有了，聂明玦聂怀桑有了，是不是还要来金陵江澄	聂怀桑	0
哈哈哈哈我谢可寅太可爱了	谢可寅	1
王总，我也掉金豆豆了😭	王总	0
u1s1孔雪儿人品确实不咋样	孔雪儿	-1
蔡卓宜双马尾真的不好看	蔡卓宜	-1
刚才就我自己看到了新说唱的何美延了吗	何美延	0
有点像韩国的林允儿。	林允儿	0
文哲也很好的	文哲	1
刘雨昕刘雨昕好可爱哈哈哈	刘雨昕	1
徐紫茵谢可寅许馨文都是下一站传奇的宝藏妹妹！！！！	徐紫茵	1
我的虞书欣，林小宅呢？！	林小宅	0
我想看金子涵，不想看安琪，整天的努力人设!悲情人设	金子涵	1
奔着李沁来的！！	李沁	1
菜徐坤好作啊	徐坤好	-1
剧里只有肖战一个帅哥	肖战	1
安崎不比孔雪儿好吗？？	孔雪儿	-1
你们这上一个小屁孩没有没了的说那个哪吒那个哪吒保护	哪吒	0
长公主是二皇子的	长公主	0
邓紫棋的歌林宥嘉不尴尬吗	林宥嘉	0
李子维黄雨萱	李子维	0
杨迪恶心下次别请了	杨迪	-1
刘亚楠笑得时候有点新901028207492	刘亚楠笑	1
邓紫棋的歌，被毁了，啊啊啊啊，受不了了😞😞😞😞😞	邓紫棋	0
说王承渲一般的你行你上a	王承渲	0
张伟：我是车神	我是车神	0
陈道明程凤台	陈道明	0
宋江开飞机准备去梁山吗？	宋江	0
喻言！！！我来啦！！！！	喻言	0
孔雪儿真的实力很强啊，你们为什么这么黑她，她以前是以前，现在是现在啊，服了你们了	孔雪儿	1
孔雪儿这张脸实在是喜欢不起来	孔雪儿	-1
申玉好恶心！！！我真的吐了	申玉好	-1
邓紫棋的歌?在林宥嘉面前唱?节目组胆子真大，炒热度炒到这种地步，NB	邓紫棋	0
刘令姿刘令姿刘令姿刘令姿刘令姿刘令姿刘令姿刘令姿刘令姿刘令姿刘令姿刘令姿刘令姿刘令姿刘令姿刘令姿刘令	刘令姿	0
申洁一看就买票了	申洁	-1
安崎侧面超像jolin	安崎	0
欧豪撩张天爱	张天爱	0
文哲也憨憨的	文哲	0
马薇薇？？？	马薇薇	0
牙太丑了不适合女团照着杨幂坐的吧	杨幂	-1
尹正下一个角色:贾宝玉	贾宝玉	0
为什么戴燕妮镜头这么少	戴燕妮	0
对孔雪儿改观了	孔雪儿	1
欧豪这个妆不错	欧豪	1
小北快来，阿念被欺负了	阿念	0
从白蛇缘起到哪吒，期待国漫崛起	白蛇缘起	0
欧豪撩张天爱	欧豪	0
没事牧尘有大浮屠塔	牧尘	0
许佳琪可！！！！！！	许佳琪	1
这是为了帮牧尘设计的吧，沈师兄有心了	沈师兄	0
金子涵好漂亮	金子涵	1
戴萌加油我就喜欢听你说话	戴萌	1
敖丙是银河奥特曼哪吒是维克特利奥特曼	哪吒	0
王清！！！！陈珏！！！	陈珏	0
不喜欢孔雪儿这样内定出道，感觉对别人不公平唉	孔雪儿	-1
金子涵安崎孔雪儿冲啊啊啊啊	孔雪儿	0
曾可妮整容了以前不长这样	曾可妮	-1
啊啊啊啊孔雪儿好飒	孔雪儿	1
申公豹的师兄是姜子牙啊	申公豹	0
原著郑易的老师说因为未成年还可塑所以法律要给他们机会，可是谁给过受害者机会	郑易	0
听歌就听歌别cue我陈立农	陈立农	0
魏辰宝贝冲呀！	魏辰	1
王承渲这也很烂啊	王承渲	-1
还有其他的黄色蓝色还有黄色还有哪吒还有他真的	哪吒	0
蔡卓妍要是出道那就真的无语了	蔡卓妍	-1
孔雪儿最强孔雪儿最强孔雪儿最强孔雪儿最强孔雪儿最强孔雪儿最强	孔雪儿	1
牧尘别随便相信别人啊	牧尘	0
哪吒长大了嘛！	哪吒	0
虞书欣妈妈来了	虞书欣	1
阿丑：哪吒抢我妹	哪吒	0
许佳琪许佳琪许佳琪许佳琪许佳琪许佳琪许佳琪许佳琪许佳琪许佳琪许佳琪许佳琪许佳琪许佳琪许佳许佳琪许佳琪	许佳琪	0
长公主怎么艳绝天下了啊，看不出来	长公主	0
以前的吕小布有多渣现在的吕子乔就有多深情	吕子乔	1
大家看看戴萌吧！	戴萌	0
美佳在吕子乔跟他相遇的第一家医院认识的	吕子乔	0
刘令姿气质超好！！！	刘令姿	1
冰清玉洁什么鬼啊！王承渲加油！	冰清玉洁	0
李小冉的水军真多。。	李小冉	-1
许佳琪长得真的有点老	许佳琪	-1
冯若航学姐冲冲冲冲冲冲冲冲冲冲冲冲冲冲冲冲冲冲冯若航冯若航冯若航冯若航冯若航冯若航冯若航冯若航	冯若航	1
不是每个陈念都有小北	陈念	0
哪吒你在哪里？	哪吒	0
文哲你是一个美女！请你注意表情管理！！	文哲	1
孔雪儿算了吧，啥啥啥不行	孔雪儿	-1
孔雪儿孔雪儿孔雪儿	孔雪儿	0
林小宅好好看	林小宅	1
假如把杨迪换成肖战，肖战答对，他都听得见，肖战以后都别来了，玩赖的玩意	杨迪	0
安崎边吃边教	安崎	0
许佳琪长得很A	许佳琪	1
金子涵你很棒真的	金子涵	1
戴萌，加油💪	戴萌	1
孔雪儿和他们根本不是一个档次觉醒出道吧	孔雪儿	1
大哪吒你是鹦鹉吗	大哪吒	0
王清就是小汤唯啊	汤唯	0
我看杨迪这段很搞笑后面他就没怎么说话了，沈腾的扔保龄球画面太啰嗦一点都不搞笑故意捧着太假	杨迪	1
没有想象中那么惊心动魄，6块钱为张涵予和袁泉	张涵予	1
刘亚楠好棒！！！	刘亚楠好棒	1
你要是说我就想让我妹妹当回C位，我们不能说啥，毕竟姐妹嘛，我可以承认申洁确实实力不错，但是还差点	申洁	0
安娜要听艾沙的话	艾沙	0
许佳琪许佳琪许佳琪许佳琪许佳琪许佳琪许佳琪许佳琪许佳琪许佳琪许佳琪许佳琪许佳琪许佳琪许佳琪许佳琪	许佳琪	0
徐紫茵徐紫茵	徐紫茵	0
这么多白骨精？悟空沉默了	悟空	0
一代蜘蛛侠哈利的父亲	蜘蛛侠	0
大哪吒:我一定要打死你	大哪吒	0
何美延怎么还有镜头？	何美延	0
申洁这个c位看的我尴尬癌要犯了	申洁	-1
艾莎女王你怎么能这么坏呢	艾莎	0
刘令姿我爱你	刘令姿	1
这皇上是肖战扮演的吧	皇上	0
安琦不行，跳成勾引舞了，还是许佳琪跳的好，简直是碾压安琦	安琦	-1
我觉得没必要因为申冰去讨厌申洁，因为申洁之前也说过，如果自己做的不好，就让渲当，主要还是申冰的问题	申洁	0
哪吒你没事吧？	哪吒	0
艾玛，给我看哭了	艾玛	0
大爱王俊凯！！！！！王俊凯演的太好了	王俊凯	1
因为肖战不配	肖战	-1
虞书欣蔡卓宜陈珏给👴冲	虞书欣	1
哪吒会揍又不会自己减吗？	哪吒	0
亚楠像孙燕姿	孙燕姿	0
大林是不是因为范思哲这牌子的梗才选的他	大林	0
申玉开始放狗屁	申玉	-1
王清比孔雪儿好	孔雪儿	-1
真的是欠周冬雨和易洋千玺一张电影票	千玺	1
现实中有太多的陈念，可是却没有小北，😭😭😭😭	小北	0
申洁真的跳得不好	申洁	-1
林宥嘉:我不是很想听唉	林宥嘉	0
没事的孔雪儿	孔雪儿	0
徐紫茵加油啊	徐紫茵	1
罗琦，罗宾的姐姐	罗宾	0
等下虞书欣票更加无语	虞书欣	-1
朱一龙比尹正好！！！！！！！！！！！！！！！	朱一龙	1
孔下半脸有点杨幂的感觉……	杨幂	0
我想要王思予镜头呜呜呜	王思予	1
张一山演技爆炸	张一山	1
reader关晓彤	关晓彤	0
觉得刚才的佳琪很不错	佳琪	1
易烊千玺可真丑	易烊千玺	-1
蔡卓宜和孔雪儿必须出道	蔡卓宜	1
如果王承渲拿到c位一定是最高分	王承渲	1
哪吒的爹是李静哪吒的娘是什么？	哪吒	0
菜徐坤太强势了，三比一都掰不过	徐坤太	0
加油！！！葛鑫怡！！！加油！	葛鑫怡	1
走了，宋江哥哥。	宋江	0
金子涵自己都不信🤨哈哈哈哈可爱	金子涵	0
王承渲！王承渲！王承渲！	王承渲	0
安琪这一个甩头，我没了	安琪	1
许杨玉琢我爱了	许杨玉琢	1
文哲长得有点像颖儿	文哲长	0
徐轸轸徐轸轸徐轸轸	徐轸轸	0
王思予王思予王思予	王思予	0
白幼宁好烦啊，什么叫开玩笑？玩笑是那么能随便开的吗	白幼宁	-1
陈念不是有点结巴吗？原著里面是小结巴	陈念	0
徐紫茵和刘亚楠我都喜欢wuwu	徐紫茵	1
啊啊啊啊啊啊，金子涵	金子涵	1
孔雪儿太容易招妒忌	孔雪儿	0
粉上了蔡徐坤！！！爱死了	蔡徐坤	1
蔡卓宜妈妈爱你！！！！	蔡卓宜	1
谢可寅：她就是离婚	谢可寅	0
刘雨昕刘雨昕刘雨昕	刘雨昕	0
看投票就知道谁实力好了别吹王承渲了	王承渲	0
魏莱要是个好人应该有很多人喜欢吧	魏莱	0
谢可寅好像温精灵	谢可寅	1
林宥嘉老师，	林宥嘉	0
你们让虞书欣这个痴汉第一是要让她去糟蹋队里的妹妹吗哈哈哈哈我靠	虞书欣	-1
申冰当小三还骂原配爽不爽啊	申冰	-1
现在的小北，终于可以仰起头了，不需要再带个帽子，或许，这就是成长吧！	小北	1
我并不觉得申洁的表现力比渲渲好。	申洁	-1
矮油，孔雪儿的得票好可惜	孔雪儿	0
最好看的是哪吒。	哪吒	1
请不要给王一博招黑	王一博	0
申洁没干嘛是她的亲友团致命	申洁	0
傻逼华晨宇娘炮一个，只会嚎叫	华晨宇	-1
刘雨昕我来啦	刘雨昕	1
说商菊贞的怕是傻子吧！侯玉魁都说了当时是和商菊贞，宁九郎，姜荣寿同台的时候偷听到的。	姜荣寿	0
许佳琪第一个A,爱奇艺你给我死	许佳琪	0
孔雪儿完全没颜值，脸是打了玻尿酸嘛	孔雪儿	-1
这个日本女孩都比孔雪儿好，姓孔的你算个什么玩意儿？	孔雪儿	-1
王清好像阿沁王清媛啊，名字也像！！！	王清	0
华晨宇华晨宇华晨宇华晨宇华晨宇华晨宇	华晨宇	0
牧尘:兄弟你看起来很会的样子	牧尘	0
王清A.........	王清	0
葛鑫怡冲啊!!!!	葛鑫怡	1
金子涵，好温柔啊！！！	金子涵	1
弹幕是不是有病？自己忘记动作了还是不想比了？四胞胎过分不代表王承渲有多好	王承渲	0
王承渲让我起鸡皮疙瘩了，可以的	王承渲	1
王清是单眼皮的雪莉吧！	雪莉	0
徐天又来找小红袄了	小红	0
蔡徐坤跟吴亦凡有点撞脸	蔡徐坤	0
来看我的安崎	安崎	1
韩雪妈妈笑死了有点像林心如	林心如	0
悟空，是你吗	悟空	0
夜华，你看看我啊，我是素素	素素	0
我想看张新成	张新成	1
花花（华晨宇）唱过！！！！！♥♥♥	华晨宇	1
陈念在前小北在后	陈念	0
想磕牧尘和沈师兄的cp	牧尘	0
许佳琪我们爱你	许佳琪	1
张总，小王加油！	张总	1
许杨玉琢冲冲冲！！！	许杨玉琢	1
喻言加油加油！	喻言	1
孔雪儿一脸平淡	孔雪儿	0
魏晨小可爱妈妈爱你	魏晨	1
黄小芸好像王源啊	王源	0
！安崎！实力全能ACE🍒爆炸小甜心❗️舞台小钢炮🌶️重庆辣妹！安崎宝贝冲！来pick安崎吧！！！	安崎	1
他不是庆帝私生子吗？老范背锅侠？	老范	0
易烊千玺!!!	易烊千玺	0
本来奔着许佳琪和孔雪儿看的，现在因为虞书欣不想看了，这TM不是黑幕？	虞书欣	-1
黄小云有点像王源	王源	0
金子涵魏辰！！	魏辰	0
许佳琪冲冲冲	许佳琪	1
刘令姿这个宝藏女孩不仅是好看啊	刘令姿	1
留个名蔡徐坤	蔡徐坤	0
呜呜呜王承渲和陈品瑄两个都很棒鸭别哭别哭	陈品瑄	1
王思予怎么这么低啊	王思予	0
孔雪儿加油呀	孔雪儿	1
本来还挺喜欢Ella老师的，但是这么说张溪杨蕊菡张楚寒就有一点过分了吧毕竟你在101还是很喜欢她们的	ella	0
张伟车不是慢，是他省油钱	张伟	0
我的爆炸甜心安琪	安琪	1
夸爆安崎“当然～”	安崎	1
忍不住评论，许佳琪长在我审美上	许佳琪	1
喜欢毛不易和周深，加油！	周深	1
周冬雨不配当女主	周冬雨	-1
我比较喜欢王承渲	王承渲	1
王欣宇太腻歪了	王欣宇	-1
毛毛还没上的时候黄霄雲就说了不论下一个是谁都要推	黄霄雲	0
我爱蔡徐坤蔡徐坤蔡徐坤蔡徐坤蔡徐坤✨✨✨✨✨✨✨✨✨	蔡徐坤	1
这是章鱼哥把	章鱼哥	0
当着林宥嘉面唱邓紫棋歌	林宥嘉	0
小哪吒快点来变我吖	哪吒	0
周深我的妈！	周深	1
张伟貌似是来搞笑的	张伟	1
哭什么林小宅，卖假货黑点石锤	林小宅	-1
申冰嗓子被宝鹃下药了？	宝鹃	0
易烊千玺好帅	易烊千玺	1
孔雪儿太美了啊啊啊啊	孔雪儿	1
华晨宇公关太不要脸了吧	华晨宇	-1
我还让了你一只手哪吒	你一	0
孔雪儿孔雪儿孔雪儿孔雪儿孔雪儿爱死你了(๑°3°๑)	孔雪儿	1
虞书欣哪个？😒	虞书欣	0
两个都师，哪吒更师！	哪吒	0
华晨宇华晨宇华晨宇	华晨宇	0
杨迪不讨喜，非常不讨喜，不红是有原因的	杨迪	-1
安崎姐姐快出道我好爱	安崎	1
欧豪还能要了么	欧豪	0
王承渲加油冲冲冲	王承渲	1
嗯，阿炳的妈妈是咋样的？	阿炳	0
多久有虞书欣啊	虞书欣	0
许佳琪许佳琪许佳琪许佳琪许佳琪许佳琪许佳琪许佳琪许佳琪许佳琪许佳琪许佳琪许佳琪许佳琪许佳琪许佳琪++	许佳琪	0
好在陈念还有小北，她们是真诚的	陈念	1
就觉得韩雪好做作啊	韩雪	-1
其实承泫的脸本身就有冲击力,再加上申洁是四胞胎，怎么练都不行	申洁	0
期待喻言和左卓	喻言	1
许佳琪冲！！！	许佳琪	1
没肖战。求求你们不要看了。	肖战	0
我觉得王牌，有贾玲和沈腾就可以了，如果她俩不在，王牌也就没啥收视率了	贾玲	1
孔雪儿配跟她们比吗	孔雪儿	-1
蔡卓宜太可以了	蔡卓宜	1
坤哥，我来了	坤哥	0
顺间觉得哪吒好可怜	哪吒	0
王承渲你很棒了，比冰清玉洁好多了，冰清玉洁就算有笑容也差得很多	冰清玉洁	-1
袁泉演技不错	袁泉	1
张楚寒不是101的吗	张楚寒	0
我觉得不是小北杀得，是替罪羊	小北	0
敖丙，哪咤？申公豹，好傻	哪咤	0
这是元始天尊？	元始天尊	0
小葵乖，把小眼睛闭上，不许睁开！！！！！！	小葵	1
虞书欣太可了！我粉了！这个小圆脸居然很高级！	虞书欣	1
这样真的不公平。赵小棠怎样也是B吧	赵小棠	0
喻言加油(ง•̀_•́)ง	喻言	1
孔雪儿管富二代各种要奢侈品最后还绿了人家捞女想红	孔雪儿	-1
相比而言，蔡卓宜low了	蔡卓宜	-1
少哪吒和敖丙玩	敖丙	0
王承渲给我出道！！	王承渲	1
神烦柳岩，能不能滚下去	柳岩	-1
虞书欣虞书欣加油虞书欣虞书欣加油虞书欣虞书欣加油	虞书欣	1
徐轸轸徐轸轸徐轸轸	徐轸轸	0
说王俊凯的出来	王俊凯	0
我现在好喜欢蔡徐坤哈哈哈哈哈	蔡徐坤	1
蕊蕊开心了二爷也笑了	二爷	0
孔雪儿我爱死你	孔雪儿	1
孔雪儿麻烦你把臭拽脸收一收吧，觉得安崎金子涵超过你你就不爽了，收收吧	孔雪儿	-1
这怎么跟晓彤和郑爽的冰雪奇缘不一样呢？	晓彤	0
蔡卓宜蔡卓宜蔡卓宜蔡卓宜蔡卓宜蔡卓宜加油！！！	蔡卓宜	1
丽萨不在电台工作，怎么看的曾小贤	丽萨	0
你是我的好朋友，哪吒	你是我的	0
侧脸好像蔡依林	蔡依林	0
上快本的应该都是A，所以安崎和上官都是A所以，，为毛说孔雪儿是首A	快本	0
第一，花花，第二应该是米希牙，第三有雨神，不喜欢周深的声音	周深	-1
蔡徐坤说得对！！！！！	蔡徐坤	1
杨迪不玩滚好吗	杨迪	-1
刚刚一瞬间大力好像丽娜	丽娜	0
所以这组需要什么体能？动作还没安琪组激烈	安琪	0
小红袄来了徐天	小红	0
有没有觉得她很像金锁时期的范冰冰	金锁	0
秦牛正威您是炒作吧	秦牛正威	-1
左卓左卓左卓左卓	左卓	0
别问什么剧了，康熙王朝。	康熙王朝	0
喻言第一期十二万买了十二秒🌝	喻言	-1
阿炳阿炳，别小看哪吒他会变申数	阿炳	0
陈品瑄给我冲！！	陈品瑄	1
繁星坠入我眼里，喻言坠入我心里✨	繁星	1
原来你是真的喜欢牧尘媳妇	牧尘	0
鲁迅说的没错，这是个吃人社会	鲁迅	0
张伟好悠闲啊	张伟	0
？？？lisa申洁可是专业抓眼球的哦	申洁	1
喻言几年前参加过加油美少女一头嚣张粉发选了c位实力印象深刻！	喻言	1
佳琪佳琪冲冲冲	佳琪佳琪	1
哪吒的爹是李静哪吒的娘是什么？	李静	0
周冬雨你都多少歲了	周冬雨	0
王心茗都没镜头，明明也很努力，坚持到最后	王心茗	1
坤哥好可爱啊	坤哥	1
陈念心里已经很憋屈了	陈念	0
刘令姿胳膊长腿长的	刘令姿	1
金子涵安琦你们出道吧！	金子涵	1
上官喜爱、安崎和许佳琪是真的可以Ａ	上官喜爱	1
蔡卓宜：我们活在这个网络发达的时代但我一点也不活在评论里	蔡卓宜	0
花花来了。邓紫棋就不会来了	花花	0
刘令姿刘令姿刘令姿刘令姿刘令姿刘令姿刘令姿刘令姿刘令姿刘令姿刘令姿刘令姿刘令姿刘令姿刘令姿刘令姿刘令	刘令	0
蔡徐坤喜欢丑的	蔡徐坤	-1
许佳琪太帅了	许佳琪	1
文哲长得像金所炫	金所炫	0
戴燕妮戴燕妮戴燕妮	戴燕妮	0
哪吒是我的好朋友。	哪吒	1
张恬熙：路飞那个认真的吗？那可是我老公啊	张恬熙	0
金子涵安崎孔雪儿冲啊啊啊啊	金子涵	1
看走位和镜头还有站位王承渲更像c位	王承渲	1
喻言我爱你❤️❤️❤️	喻言	1
黄婷婷耶，好久没有你的动态了，😭	黄婷婷	0
金子涵！！！！金子涵！！！！金子涵！！！！金子涵！！！！	金子涵	1
啊啊啊啊魏辰魏辰魏辰魏辰	魏辰	1
长公主的打扮好大一股风尘味，活脱脱一风尘女子	长公主	-1
陆柯燃陆柯燃陆柯燃陆柯燃	陆柯燃	0
啊啊啊啊啊KIKI！许佳琪！仙女❤️	许佳琪	1
我我我对孔雪儿黑转粉了对不起漂亮姐姐	孔雪儿	1
汪睿抄袭艾薇儿	汪睿	-1
这是有点想取代白娘子赵雅芝？	赵雅芝	0
金大牙演得好	金大牙	1
蔡卓宜蔡卓宜蔡卓宜蔡卓宜蔡卓宜蔡卓宜加油！！！	蔡卓宜	1
魏辰魏辰魏辰魏辰魏辰魏辰魏辰魏辰魏辰	魏辰	0
就是你不配申洁	申洁	-1
刘亚楠，刘亚楠，刘亚楠	刘亚楠	0
费玉清那个别走	费玉清	0
太乙真人拿的是哪吒，申公豹拿的是敖丙	敖丙	0
啊啊啊啊易烊千玺阿玛尼	易烊千玺	0
许佳琪太可爱了！	许佳琪	1
蔡卓宜我爱你	蔡卓宜	1
下次去现场喊你的名字刘令姿~	刘令姿	1
金子涵多说说话哈哈哈	金子涵	0
啊啊啊啊啊啊啊太可爱了安崎	安崎	1
张总眼睛里有种光	张总	1
蔡徐坤想死吗	蔡徐坤	-1
虞书欣冲啊！1号位真好，希望一直这样，欣欣也加油！	欣欣	1
这个魏辰闪光点很多的，能不能多给点镜头	魏辰	1
那个孔雪儿就是来赚流量的	孔雪儿	-1
谢可寅三哥冲啊	谢可寅	1
又看到喻言了	喻言	0
今天好像没有小棠	小棠	0
阿炳阿炳，别小看哪吒他会变申数	哪吒	0
蔡卓宜冲啊!	蔡卓宜	1
不敢置信，，，毛毛唱的我都哭了	毛毛	1
第一名花花，第二名不是毛毛就是周深，能感觉到的，因为太好听了，就是有实力	毛毛	1
好像申冰傍边的那个女的说了一句卧槽？	申冰	0
不是很喜欢这个佳琪跟雪儿哎，可能我审美有问题。。。	佳琪	-1
我是学舞蹈的客观的说孔雪儿这个舞蹈和许佳琪的舞蹈难度不是一个水平的没什么可比性	孔雪儿	0
说孔雪儿头发丝怕不是没见过罗捷头发丝吧	罗捷	0
牧尘好纯真！！！！	牧尘	1
陈美嘉的密码是3602。	陈美嘉	0
看不懂的移步隔壁oxlxs看看陈立农前辈的初评级，别整天就蔡徐坤太宽，张艺兴他们不也给陈立农了个a	陈立农	0
蔡卓宜为什么这么多粉丝	蔡卓宜	0
第一名花花，第二名不是毛毛就是周深，能感觉到的，因为太好听了，就是有实力	花花	1
看看我谢可寅吧各位	谢可寅	1
孔雪儿真的好像杨幂。。。。。	杨幂	0
秦牛正威真的该滚了，之前和吴亦凡搞cp，炒作？？？后来分了吴亦凡还没说什么她自先把关系摆脱了	秦牛正威	-1
虞书欣冲冲冲	虞书欣	1
申冰名字改成训练生了	申冰	0
算了孟鹤堂保护不了我。他自己也害怕	孟鹤堂	0
可恶的血灵子，等牧尘成了大主宰，你再和他斗！	血灵子	-1
陈道明绝了，不愧老戏骨	陈道明	1
申洁真的好丑	申洁	-1
我之前挺讨厌许佳琪，但我觉得女孩子都应该被保护，所以大家就好好看比赛不要骂这群可爱的女孩子啦	许佳琪	0
确实海王是到花果山找孙悟空学了棍法	海王	0
旁边申洁骂了句艹，有没有人听到	没有	0
蔡卓宜！！！！！！蔡卓宜！！！！！！！！！！！	蔡卓宜	1
金子涵的眼神绝了！直戳我心啊！	金子涵	1
喻言喻言喻言冲冲冲	喻言	0
刚才魏辰一瞬间有点像金请夏	金请夏	0
周深好棒～喜欢毛毛爱毛毛	毛毛	1
毛毛的牙齿其实挺好的啊，总是害羞呢	毛毛	1
林小宅卖山寨才让人讨厌	林小宅	-1
王思予啊啊啊啊加油加油！	王思予	1
王思予王思予王思予王思予王思予王思予王思予王思予	王思予	0
太可爱啦王承渲宝贝	王承渲	1
蔡卓宜加油吖蔡卓宜加油吖蔡卓宜加油吖	蔡卓宜	1
我是特意要来听艾莎，唱Letitgothe的	艾莎	0
笑死了，哈哈哈，韩雪太可爱了	韩雪	1
牧尘不要想信他炅坏人	牧尘	0
蔡卓宜的长相就蛮适合女团	蔡卓宜	1
艾玛又来作妖	艾玛	-1
赵海棠好烦这是爱五最烦的	赵海棠	-1
太烦白幼宁了！！！	白幼宁	-1
灭霸？？？？	灭霸	0
许佳琪油腻死了	许佳琪	-1
防爆徐紫茵吗	徐紫茵	0
训练生那个应该就是申冰了	申冰	0
王承渲的实力真的可以	王承渲	1
哇哦买票买这么多呢?申洁	申洁	-1
赵小棠说得对	赵小棠	1
申洁买了吧？？？？？	申洁	-1
求大家多多关注下魏辰宝宝吧！	魏辰	1
李小冉皮肤真好	李小冉	1
胡一菲的T恤来一件	胡一菲	0
这是长公主！！？？我看是白骨精	长公主	-1
林小宅进步了	林小宅	1
哪吒：我是国宝，谁敢动我	哪吒	0
快去给戴燕妮投票	戴燕妮	1
灭霸都没有妈妈厉害，他算个啥？	灭霸	0
张艺兴保护我	张艺兴	0
那个姓查的不太行，参加过起舞吧齐舞，查祎琛性格有点不讨喜，挺作	查祎琛	-1
徐紫茵冲鸭🦆	徐紫茵	1
长公主还是很厉害的，不过和陈萍萍比嫩了点，动范闲你不怕陈萍萍吗	陈萍萍	0
我去口型是乔楚生吧！	乔楚生	0
话不多说欧豪最牛掰	欧豪	1
徐轸轸徐轸轸徐轸轸、	徐轸轸	0
弄死魏莱对全世界都好	魏莱	0
喻言！！！喻言喻言	喻言	0
李小冉不适合古装	李小冉	-1
安琪震到我了	安琪震	1
杨迪是凭实力火的不然为什么娜姐会捧他那么多导演找他拍戏呢	杨迪	1
金子涵孔雪儿女团标志	金子涵	1
莎莎也跳过这个舞蹈的！	莎莎	0
温宁思追有了，聂明玦聂怀桑有了，是不是还要来金陵江澄	温宁	0
子轩在一起穿了	子轩	0
喻言你怎么辣么好	喻言	1
砍这几个男人还是张涵予靠谱	张涵予	0
尤长靖啊啊啊啊啊啊啊啊啊啊啊	尤长靖	1
这就是猩球崛起的凯撒	凯撒	0
柳岩出道自己一个人打拼到现在没有什么背景很不容易了	柳岩	1
出轨的是孔雪儿谢谢	孔雪儿	-1
这大腿蔡卓宜唱的不行，，	蔡卓宜	-1
申公豹也是一个好师父	申公豹	1
长公主假发太丑了	长公主	-1
虞书欣虞书欣虞书欣虞书欣虞书欣虞书欣虞书欣虞书欣虞书欣	虞书欣	0
这个比孔雪儿好吧	孔雪儿	-1
哪吒什么时候出现？	哪吒	0
孔雪儿有脸哭	孔雪儿	-1
林小宅杀到我了啊啊啊啊啊啊啊啊啊啊啊啊！！！！！！！！	林小宅	1
假面超人蔡卓宜	蔡卓宜	-1
赵小棠你真酷	赵小棠	1
披金斩棘不畏涵霜金子涵金子涵金子涵金子涵冲鸭披金斩棘不畏涵霜金子涵金子涵金子涵金子涵冲鸭！	涵霜	1
周深好棒～喜欢毛毛爱毛毛	周深	1
金子涵从小就这么美啊啊啊啊啊	金子涵	1
戴燕妮真的CL都拿不到镜头绝了	戴燕妮	0
其实申冰最遭人烦	申冰	-1
刘令姿刘令姿刘令姿刘令姿刘令姿刘令姿	刘令姿	0
无语了孔雪儿	孔雪儿	-1
呜呜呜没有虞书欣	虞书欣	0
王一博护体哇哦	王一博	0
申公豹说的对，太乙真人是一个死胖子。	太乙真人	-1
八贤王演得好	八贤王	1
师姐汪睿加油	汪睿	1
前面说许佳琪不自然的，丝芭那么严，钱还少，她哪有钱去整容	许佳琪	0
李靖甄子丹配音	甄子丹	0
莎莎在这里是有发言权的	莎莎	1
汪睿抄袭艾薇儿	艾薇儿	0
华晨宇：我把架子扛下去，看你们还怎么唱？	华晨宇	0
哪吒好厉害啊！	哪吒	1
蔡卓宜笑起来太像张予曦了	蔡卓宜	0
？？！？！？！？！？毛毛的直击心灵！！！怪在没有歌词	毛毛	1
罗琦，罗宾的姐姐	罗琦	0
长公主还是很厉害的，不过和陈萍萍比嫩了点，动范闲你不怕陈萍萍吗	长公主	1
她拍火凤凰之前就是范冰冰的替身	火凤凰	0
虞书欣麻麻爱你。💜虞书欣冲冲冲！！！虞书欣麻麻爱你。💜虞书欣冲冲冲！！！虞书欣麻麻爱你。💜虞书欣冲冲冲！！！虞书欣麻麻爱你。💜	虞书欣	1
左卓左卓左卓冲啊！	左卓	1
你一票我一票，安崎明天就出道啊啊啊啊啊啊啊，安崎妈妈爱你啊啊啊啊啊	安崎	1
安琪真的a爆了	安琪	1
下一步姜子牙	姜子牙	0
刘亚楠披发比之前好看许多啊	刘亚楠	1
我觉得没必要因为申冰去讨厌申洁，因为申洁之前也说过，如果自己做的不好，就让渲当，主要还是申冰的问题	申冰	-1
三界里三个家伙不能惹，一个猴子，一个杨戬，一个哪吒	哪吒	0
王承渲你很棒了，比冰清玉洁好多了，冰清玉洁就算有笑容也差得很多	王承渲	1
蔡卓宜啊啊啊啊啊	蔡卓宜	1
哭了为什么王思予这么好听的声音只有两句	王思予	1
王承渲！！！！！	王承渲	0
孔雪儿冲冲冲	孔雪儿	1
大林崽崽艾伦	大林	0
小北好帅啊！	小北	1
说杨迪听得见的都是傻逼	杨迪	0
我觉得王挺显眼的啊	王挺	0
金子涵金子涵金子涵金子涵	金子涵	0
有点像土屋安娜的声音。。。	土屋安娜	0
黄小芸有一点点像我老公二字源源耶	黄小芸	0
不可能蕊蕊在原著现在才十多岁不到20岁数都对不上真厉害	蕊蕊	0
申公豹说话真是结结巴巴。	申公豹	0
葛鑫怡加油！！	葛鑫怡	1
第二排张伟大力	张伟	0
嘴形乔楚生我的妈呀	乔楚生	0
。。。蔡卓宜唱得也好听啊	蔡卓宜	1
你是三哥徐天	徐天	0
蔡卓宜离过婚，还整过容，已经被曝光了	蔡卓宜	-1
许佳琪我爱你啊啊啊啊啊啊啊	许佳琪	1
我不明白元始天尊为啥子收这个恶人当徒弟？	元始天尊	0
喻言之前很可爱的！	喻言	1
申洁在哪。。	申洁	0
曾小贤猜题也是这样剧情安排的妥妥当当	曾小贤	0
刘雨昕刘雨昕	刘雨昕	0
安崎好小一只哈哈哈	安崎	0
我觉得文哲有点像金所炫，眼睛像	金所炫	0
妮妮好甜啊啊啊啊啊啊啊	妮妮	1
大林崽崽艾伦	艾伦	0
安崎快出道吧！	安崎	1
王承渲加油！！！	王承渲	1
假如把杨迪换成肖战，肖战答对，他都听得见，肖战以后都别来了，玩赖的玩意	肖战	-1
安琪！！！妈妈爱你	安琪	1
徐轸轸徐轸轸徐轸轸	徐轸轸	0
长公主也行啊	长公主	0
薛之谦的歌可以	薛之谦	0
张恬熙：路飞那个认真的吗？那可是我老公啊	路飞	0
上快本的应该都是A，所以安崎和上官都是A所以，，为毛说孔雪儿是首A	孔雪儿	0
金子涵，走花路吧，你值得更好的！！！！！	金子涵	1
弱弱的说我觉得申洁还行	申洁	1
金子涵金子涵金子涵金子涵金子涵	金子涵	0
挺喜欢孔雪儿的	孔雪儿	1
刘令姿你太好看了给我出道	刘令姿	1
王承渲我去给你投	王承渲	1
沈腾想笑死我，好继承我的花呗吗？	沈腾	0
毛毛没有关系的我想哭了	毛毛	0
四个导师小王张总的叫真的好可爱	张总	1
魏辰一个近景镜头	魏辰	0
夜华，你看看我啊，我是素素	夜华	0
高晓松也太油腻了？！	高晓松	-1
不争不抢金子涵别佛了呀	金子涵	0
第一，花花，第二应该是米希牙，第三有雨神，不喜欢周深的声音	花花	0
王承渲妈妈爱你冲冲冲！	王承渲	1
张新成是中央戏剧学院音乐剧专业的	张新成	0
许佳琪许佳琪许佳琪许佳琪许佳琪许佳琪许佳琪许佳琪许佳琪许佳琪	许佳琪	0
啊啊啊啊啊啊刘雨昕太可爱了吧！妈妈爱你	刘雨昕	1
刘柏辛说不奇袭袁娅维，怕伤袁娅维的心……我的天那，没事的，奇袭袁娅维吧😕	袁娅维	0
潘金莲，你给我站住	潘金莲	0
魏辰性格好好阿	魏辰	1
哪吒真可爱！	哪吒	1
不是你不好，是申洁太差了	申洁	-1
太恶心了。申冰	申冰	-1
看到欧豪的样子又忍不住笑了	欧豪	0
不要在别的地方提虞书欣！	虞书欣	0
防弹少年团的血汗泪？动作一模一样	血汗泪	0
好喜欢王总和张总啊！！！太快乐了	王总	1
这组我刷了十遍了舞台效果绝!!!靠啊啊啊啊啊啊啊啊刘令姿给爷冲	刘令姿	1
安崎比孔雪儿强多了	安崎	1
痣真的是安崎的特色	安崎	0
戴萌太帅气了	戴萌	1
刘柏辛说不奇袭袁娅维，怕伤袁娅维的心……我的天那，没事的，奇袭袁娅维吧😕	刘柏辛	0
坤哥眼睛快闭上，这姐姐太厉害了(ง•̀_•́)ง	坤哥	0
魏辰镜头呢？有实力的小姐姐不值得更多镜头吗？	魏辰	0
盲猜安琪如果出道会当队长	安琪	0
金子涵孔雪儿女团标志	孔雪儿	1
所做的一切都是为了陈念	陈念	0
王承渲很会抓镜头快出道吧	王承渲	1
申公豹是不是在说谎？	申公豹	0
王青比孔雪儿好多了好吧	王青	1
魏辰加油啊，希望魏辰有镜头，多一点	魏辰	1
牧尘终于知道了	牧尘	0
为什么她们那么好都拿不到A？？哪点不比孔雪儿好？？	孔雪儿	-1
卧槽妈的说你该，那个申洁当个屎中心位，明明承渲更适合好吗，委屈个屎装什么婊子	申洁	-1
周冬雨，易烊千玺演技好好。	易烊千玺	1
萧敬腾杨坤羽泉张杰都是最美和声的导师！	萧敬腾	0
表白雪梨的张新成	张新成	1
杨迪假了点吧	杨迪	-1
孔雪儿加油！不要在意流言蜚语！！	孔雪儿	1
坤哥我太爱你了，明白人	坤哥	1
看见王欣宇就生理不适	王欣宇	-1
王欣宇好有周深的感觉啊	王欣宇	1
张语格绝对低了	张语格	0
啊啊啊啊傅如乔	傅如乔	1
因为二爷在蕊蕊面前智商为零	二爷	0
这些一直刷蔡徐坤的你们是不是有病啊	蔡徐坤	-1
林宥嘉在现场听《我的秘密》，哈哈	林宥嘉	0
毛毛的发色好好看	毛毛	1
弹幕别烦了好吗安崎实力好不好导师会看。说别人用力过猛这舞蹈本来就这样的吧而且安崎如果实力不好lisa也不会夸她	安崎	0
刘令姿加油！！！	刘令姿	1
啊！！！是李现！我男神！	李现	1
魏辰小姐姐~	魏辰	0
孔雪儿真难看	孔雪儿	-1
申洁好自恋啊跳的不好还想出风头	申洁	-1
杨旭那个。我同学？	杨旭	0
赵小棠冲冲冲啊	赵小棠	1
王琳凯保护我，蔡徐坤保护我，陈立农保护我。	蔡徐坤	0
说商菊贞的怕是傻子吧！侯玉魁都说了当时是和商菊贞，宁九郎，姜荣寿同台的时候偷听到的。	侯玉魁	0
蕊蕊的玉佩？！！！不会是阿哥吧	阿哥	0
这是为了保护陈念	陈念	0
喜欢花花，毛毛，萧敬腾	毛毛	1
许佳琪许佳琪	许佳琪	0
金子涵加油啊	金子涵	1
蔡卓宜蔡卓宜！	蔡卓宜	0
坤坤比较喜欢张总	坤坤	0
许杨玉琢有被可爱到	许杨玉琢	1
真的是早就知道许佳琪是稳赢了	许佳琪	0
牛逼哪吒牛逼啊，哪吒去丙并￼	哪吒	1
许佳琪！！！	许佳琪	0
太乙真人被黑的最惨的一次阿，跟猪八戒一样啊，	猪八戒	0
王思予王思予王思予	王思予	0
许杨玉琢感觉就是在剧场讲mc	许杨玉琢	0
陈念只要你回头我一直都在	我一直都在	0
太讽刺了。胡小蝶的死就没人过问了么。	胡小蝶	0
哪吒毕竟还是个孩子……	哪吒	0
好期待周冬雨的坚若磐石	周冬雨	1
申冰和傻逼一样说他妈你不配	申冰	-1
徐紫茵给莪冲啊！！！	徐紫茵	1
赵小棠内句“你也配”粉她了！！！	赵小棠	1
安崎的挑眉我疯了！	安崎	1
史迪仔魏辰冲冲冲！	史迪仔	1
冯若航学姐冲冲冲冲冲冲冲冲冲冲冲冲冲冲冲冲冲冲冯若航冯若航冯若航冯若航冯若航冯若航冯若航冯若航	冯若航	1
葛鑫怡你笑死我了	葛鑫怡	1
韩雪太装了吧	韩雪	-1
罗大舅了，妹妹没做坏事娜扎。	罗大舅	0
在林宥嘉面前唱邓紫棋的歌？害	邓紫棋	0
刘令姿真的美我天	刘令姿	1
白幼宁这个人设在大部分情况下真的不讨喜，总让人觉得她很讨厌，这部剧中她的故事不够完整	白幼宁	-1
王思予唱歌好好听！！	王思予	1
王思予高音好好	王思予	1
我粉你～蔡卓宜！！加油	蔡卓宜	1
华晨宇我想和你说一件事就是我爱你呀！	华晨宇	1
虞书欣我爱你!!	虞书欣	1
啊啊啊啊许佳琪太帅了吧啊啊啊啊	许佳琪	1
许佳琪还可以的	许佳琪	1
难道就我一个人不喜欢许佳琪？	许佳琪	-1
Lisa:虽然曾小贤长的丑啥也不是，但你也不能绿她呀	lisa	0
承包一闪而过的朱林雨！！！呜呜呜呜好好康！！！	朱林雨	1
孔雪儿孔雪儿冲呀	孔雪儿	1
只要不是申洁第一我就好开心	申洁	0
比邓紫棋还是差点	邓紫棋	0
喜欢毛不易和周深，加油！	毛不易	1
王俊凯保护我太吓人了	王俊凯	0
黄小芸爱你爱你爱你	黄小芸	1
关永山老奸巨猾	关永山	-1
许佳琪真的不行	许佳琪	-1
安娜公主小时候好可爱哟。	安娜公主	1
小葵好可爱，啊啊啊啊，沦陷了	小葵	1
要是张艺兴来评分的话一堆F，估计F班都堆不下了吧	张艺兴	0
徐紫茵梆梆的爱心	徐紫茵	1
你一票我一票安崎C位出道	安崎	1
申冰被爆当小三实锤退赛了	申冰	-1
徐紫茵加油！！	徐紫茵	1
那个海军同意克比入伍也算是还路飞人情吧	路飞	0
徐佳莹高估自己，低估王菲	徐佳莹	-1
葛鑫怡葛鑫怡	葛鑫怡	0
刘令姿我爱你	刘令姿	1
吕子乔的男科医院广告哈哈哈	吕子乔	0
华晨宇华晨宇华晨宇华晨宇华晨宇华晨宇	华晨宇	0
范丞丞，保护我	范丞丞	0
爱你安崎给我冲	安崎	1
披金斩棘不畏涵霜金子涵金子涵金子涵金子涵冲鸭披金斩棘不畏涵霜金子涵金子涵金子涵金子涵冲鸭！	金子涵	1
安崎队长出道吧	安崎	1
吴京要是主演那估计还得和战斗机空战半小时	吴京	0
能选五月天起码品味不错，不过感觉还是只有阿信唱得有味道	阿信	1
安琪太野了，性感小野豹	安琪	1
王源真的够义气啊	王源	1
肖战和陈道明都是配角啊	陈道明	0
说实话我不喜欢白幼宁，还有她的八字眉	白幼宁	-1
为什么申冰写的是训练生？	申冰	0
许佳琪许佳琪许佳琪许佳琪许佳琪许佳琪许佳琪许佳琪许佳琪许佳琪许佳琪许佳琪许佳琪许佳琪许佳琪许佳琪	许佳琪	0
这不是王源吗？	王源	0
真心烦关晓彤	关晓彤	-1
秦牛正威好恶心哈哈	秦牛正威	-1
许佳琪颜值在线舞蹈又跳的那么好。	许佳琪	1
绿茶婊孔雪儿	孔雪儿	-1
谢可寅和虞书欣就是我的快落源泉	谢可寅	1
陈珏，陈珏，陈珏	陈珏	0
王承渲真的好努力	王承渲	1
这哪吒和敖丙就是鸣人和佐助的影子，剧情和中心思想也来自火影忍者	佐助	0
这样的话孔雪儿就不是首A了呀	孔雪儿	-1
孔雪儿龅牙，脚踏两只船	孔雪儿	-1
孔雪儿孔雪儿孔雪儿冲冲冲	孔雪儿	1
曾可妮演过惹不起的殿下大人里面一个异国公主	曾可妮	0
王清我太喜欢她了	王清	1
前面喷韩雪的打脸不？是不是脸都红了	韩雪	0
杨紫能跟李沁比？杨紫多丑没点数？	杨紫	-1
林小宅跳的不错啊	林小宅	1
顺子看的很认真啊	顺子	0
小爷好可爱我好喜欢看看哪吒知道个什么呀	哪吒	0
刘雨欣太帅啦！！！	刘雨欣	1
魏辰魏辰魏辰魏辰魏辰魏辰魏辰	魏辰	0
蔡卓宜加油，期待你未来更好的舞台	蔡卓宜	1
这就是太乙和申公豹的区别	太乙	0
苏明玉的家呀	苏明玉	0
刘令芝之前妆容有点像孟美岐	刘令芝	0
孔雪儿孔雪儿孔雪儿冲冲冲	孔雪儿	1
啊！我太爱毛毛了！我来就是看毛毛和花花的	毛毛	1
下面的吴京请注意	吴京	0
蔡卓宜妈妈爱你！！！	蔡卓宜	1
哪吒娘是饿了吧	哪吒	0
为啥林宥嘉一来就全是邓紫棋的哥哈哈哈	林宥嘉	0
葛鑫怡加油！！	葛鑫怡	1
该说不说许佳琪真美啊	许佳琪	1
许佳琪许佳琪许佳琪许佳琪许佳琪许佳琪许佳琪许佳琪许佳琪许佳琪许佳琪许佳琪许佳琪许佳琪许佳琪许佳琪++	许佳琪	0
大麟子是来搞笑的吗？	大麟子	0
袁娅维更高级，这个类型的歌她都不知道唱了多少了	袁娅维	1
陈珏加油期待你	陈珏	1
莫寒好可爱啊啊啊啊啊啊啊啊啊啊啊	莫寒	1
秦牛正威冲啊让丙丙后悔去	丙丙	0
沈腾这是要笑死人的节奏	沈腾	1
我可是哪吒呀我还能被你打趴下哈哈可笑	哪吒	0
申公豹是坏人，可怜他啥	申公豹	0
我看着很舒服啊，这首歌舞蹈就是要有力，可以去看看蔡依林的舞台	蔡依林	1
申洁：你可闭嘴吧	申洁	0
为什么要用把脸化黑呢，张云龙脖子比脸都白	张云龙	0
罗大舅了，妹妹没做坏事娜扎。	娜扎	0
金子涵小姐姐我爱了	金子涵	1
白幼宁就这样是早了不会喜欢路垚的，但凡有点感情都不会这么做的	路垚	0
蕊蕊的玉佩？！！！不会是阿哥吧	蕊蕊	0
刘雨昕刘雨昕刘雨昕	刘雨昕	0
史迪仔魏辰冲冲冲！	魏辰	1
孔雪儿得了A？	孔雪儿	-1
冯绍峰与法国队	冯绍峰	0
怎么觉得小崽和李小璐很像	李小璐	0
喜欢花花，毛毛，萧敬腾	萧敬腾	1
虞书欣虞书欣	虞书欣	0
对不起真的好吹爆陈老师不可了	陈老师	1
坤哥喜欢爆炸头他觉得可爱	坤哥	0
魏辰魏辰魏辰魏辰魏辰————！！！！！	魏辰	0
刘长健：相信我	刘长健	0
申洁爱你审结爱你	申洁	1
觉得牧尘杀他爹还是太草率，不杀还有救	牧尘	0
刘令姿刘令姿刘令姿刘令姿刘令姿刘令姿刘令姿刘令姿刘令姿刘令姿刘令姿刘令姿刘令姿刘令姿刘令姿刘令姿刘令	刘令姿	0
啊啊啊啊啊啊啊啊啊啊啊啊啊啊啊啊周深	周深	1
蔡卓宜也很棒！	蔡卓宜	1
觉得申洁也很好，王承渲强捧之耻	申洁	1
孔雪儿，不喜欢	孔雪儿	-1
不是得第一的才有100秒表演时间吗？不是虞书欣吗？怎么是许佳琪了！	许佳琪	0
戴燕妮谢可寅刘雨昕黄小芸金子涵刘亚楠王承渲安崎赵小棠	赵小棠	0
白幼宁真的好烦	白幼宁	-1
啊啊啊啊啊啊啊啊啊啊王承渲太帅了	王承渲	1
谁跟我同名蒋凯	蒋凯。	0
这不比孔雪儿好多了？？？	孔雪儿	-1
刷肖战的没妈	肖战	-1
魏辰啊啊啊啊啊啊！！！冲冲冲！	魏辰	0
难道不觉得蔡卓宜和沈梦辰很像吗	蔡卓宜	0
像不像黎明！我的天！！！！	黎明	0
孔雪儿冲冲冲！	孔雪儿	1
蔡卓宜的业务能力太差了杨超越都不如	蔡卓宜	-1
肖燕配音一直有问题	肖燕	0
刘令姿刘令姿	刘令姿	0
别理那帮喷子柳岩你最棒	柳岩	1
孔雪儿嘴巴好丑	孔雪儿	-1
蔡徐坤情商好低	蔡徐坤	-1
这不是王源吗	王源	0
蔡卓宜别的不说长得真好看	蔡卓宜	0
林小宅让我大吃一惊	林小宅	1
林宥嘉和邓紫棋在节目里永远躲不开彼此的歌	邓紫棋	0
高松是不是已经死了	高松	0
沈腾这个腿真的无语了。	沈腾	0
孔雪儿劈腿天后凑什么热闹	孔雪儿	-1
王青像汤唯和钟丽缇的结合	汤唯	0
确实比袁娅维好啊~开口脆	袁娅维	-1
别给虞书欣镜头好吗？	虞书欣	-1
孔雪儿脸色有点不太对哈哈哈哈	孔雪儿	0
柳岩，你会幸福的	柳岩	1
孔雪儿还是别出道了吧	孔雪儿	-1
越来越像薛之谦了	薛之谦	0
林小宅原来会跳舞💃🏻	林小宅	0
她们任何一个人都比孔雪儿强多了	孔雪儿	-1
陈念真是毒心肠，贱货被魏莱打怎么不牛B！贱人	陈念	-1
孔雪儿跳舞是真的可以呀	孔雪儿	1
蔡卓宜加油！活在网络发达的年代总比活在没有网络和机会的年代“有很多有梦想的人都被埋没的好。”	蔡卓宜	1
孔雪儿实力确实挺强的阿，有韩国女团的感觉	孔雪儿	1
魏辰表情管理太好了啊	魏辰	1
我笑了。申洁什么鬼。明明渲最好。	申洁	-1
王源笑的也太好看了	王源	1
能不能不要让杨迪来恶心人了	杨迪	-1
留个记号，王敏	王敏	0
金子涵安琦你们出道吧！	安琦	0
哪吒，来啦……	哪吒	0
申冰这一身真的绝了	申冰	1
杨迪只是看的东西有年代感不要说透题了好不	杨迪	0
申冰感觉是四姐妹里最会作妖的，果然最近的事，她退出了	申冰	-1
王睿的实力很高的	王睿的	1
我个人不喜欢许佳琪🙃🙃🙃	许佳琪	-1
世界欠我一个小北	小北	0
有感情啊也有技巧，不要因为奇奇成功了就说人家	奇奇	0
我觉得冰清玉洁最好的还是申洁，申洁比其他三个有自知之明，也比其他三个努力	申洁	1
许佳琪如果不C位出道就没道理	许佳琪	1
这怎么跟晓彤和郑爽的冰雪奇缘不一样呢？	郑爽	0
留个名，李小龙	李小龙	0
太乙真人：嘿嘿，没想到吧，我又出逃出来了。哪吒：我崩溃了呀，我彻底崩溃了呀，崩上天了我。	哪吒	0
啊啊啊萧敬腾	萧敬腾	1
那个很有气质的小姐姐叫刘令姿哦	刘令姿	1
拜托你们有点智商不要对杨迪人生攻击好吗	杨迪	0
文哲大气啊适合综艺主持	文哲	1
柳慕白一点都不信任他的朋友们啊，无语，大家都在帮他	柳慕白	0
陈晓最适合演	陈晓	1
戴燕妮给我出道！！！！	戴燕妮	1
上官喜爱的头发也真不好看🤮🤮🤭🤭☹️😣😖😱	上官喜爱	-1
华晨宇我爱你	华晨宇	1
金子涵金子涵金子涵金子涵	金子涵	0
费费是沈涛的老婆吧？	费费	0
柳岩学C罗庆祝动作	柳岩	0
孟子义，陈情令里的温情	温情	0
张天爱有点做作？	张天爱	-1
求求大家捞一下魏辰妹妹吧求求大家捞一下魏辰妹妹吧求求大家捞一下魏辰妹妹吧求求大家捞一下魏辰妹妹吧	魏辰	0
虞书欣好高啊	虞书欣	1
申公豹说的对，太乙真人是一个死胖子。	申公豹	0
薛之谦薛之谦薛之谦薛之谦薛之谦	薛之谦	0
刘柏辛说不奇袭袁娅维，怕伤袁娅维的心……我的天那，没事的，奇袭袁娅维吧😕	袁娅维	0
充钱的女人才配得上易烊千玺	易烊千玺	0
虞书欣好好笑啊哈哈	虞书欣	1
又是林小宅的画面恶心	林小宅	-1
虞书欣??有毛病吧	虞书欣	-1
哪吒脖子上的圈怎么不见了	哪吒	0
说王源的给我出去这是王俊凯	王俊凯	0
蔡卓宜不需要表演很好分也高	蔡卓宜	0
无语虞书欣和蔡卓宜，除了人气一点实力都没有，凭啥前十	虞书欣	-1
下一步哪吒要等多久？	哪吒	0
我觉得文哲有点像金所炫，眼睛像	文哲	0
想徐锦江果然是你	徐锦江	0
孔雪儿不配A	孔雪儿	-1
刘令姿好有气质	刘令姿	1
小北在路旁的柱子上绑了一路的花🌸	小北	0
就喜欢陈珏这样人狠话不多的	陈珏	1
魏辰魏辰魏辰魏辰魏辰魏辰魏辰	魏辰魏辰	0
这就看出来七穗和蔡卓宜实力的差距了	蔡卓宜	0
白幼宁真讨厌	白幼宁	-1
说骂肖战的出去的，这里没有肖战，要出也是你们出去	肖战	0
我听到的台下都是蔡徐坤，蔡徐坤，蔡徐坤，蔡徐坤，蔡徐坤，蔡徐坤，蔡徐坤，蔡徐坤，蔡徐坤，蔡徐坤。	蔡徐坤	0
林小宅也很帅啊	林小宅	1
许佳琪给我充，加油	许佳琪	1
葛欣亿好像郑爽	郑爽	0
喻言喻言加油	喻言	1
喻言跟我儿子同名，天天看你们刷得我好嗨	喻言	-1
王青比孔雪儿好多了好吧	孔雪儿	-1
徐紫茵小姐姐冲鸭！	徐紫茵	1
get到蔡徐坤了	蔡徐坤	1
左卓左卓左卓左卓	左卓	0
喻言这领导能力厉害了	喻言	1
牧尘你聪明点	牧尘	0
胡一菲弹一闪我挺你！	胡一菲	1
金子涵，冲冲冲	金子涵	1
哪吒超帅的！	哪吒	1
看过宋丹丹的就知道，沈腾不仅没招黑，还增加节目效果。这才是节目的目的，看输赢的去体育频道。	宋丹丹	0
滚你妈的肖战	肖战	-1
啊啊啊啊啊，安琪	安琪	1
孔雪儿孔雪儿孔雪儿孔雪儿孔雪儿爱死你了(๑°3°๑)	孔雪儿	1
后期娜美的胳膊流血了	娜美	0
这招跟孙悟空学的	孙悟空	0
没有滤镜韩雪很老辣眼睛	韩雪	-1
申冰唱的写的是训练生	申冰	0
喻言！！！喻言喻言	喻言	0
虞书欣虞书欣	虞书欣	0
顺子不会也爱上蕊蕊了	顺子	0
。易烊千玺最帅。	易烊千玺	1
滕梓荆是冀遇了吗	滕梓荆	0
实力vocal马蜀君	马蜀君	1
王清好像阿沁王清媛啊，名字也像！！！	阿沁	0
王清好温柔！！！	王清好	1
谢可寅有参加下一站传奇rap更好呢加油！	谢可寅	1
虞书欣也没有	虞书欣	0
许佳琪给我冲冲冲，把虞书欣那个绿茶婊挤下去	虞书欣	-1
少哪吒和敖丙玩	哪吒	0
别给葛鑫怡这个丑b小三镜头了	葛鑫怡	-1
喻言宝贝我来了	喻言	1
刘令姿好好看	刘令姿	1
孔雪儿脸好僵	孔雪儿	-1
跟咖喱酱没关系，就是美嘉自己作的，悠悠还和张伟拥抱过呢	咖喱酱	0
朱一龙比尹正好！！！！！！！！！！！！！！！	尹正	0
安琪除了个性突出，太用力其实是没实力的表现	安琪	-1
徐天又来找小红袄了	徐天	0
敖丙:哪吒你多少注意下我的感受😂😂😂	敖丙	0
其实文哲蛮可以的关注一下吧	文哲蛮	0
如果不是剪辑的问题，孔雪儿应该不是首A吧	孔雪儿	-1
安崎的声音是真的好听	安崎	1
谢可寅有参加下一站传奇rap更好呢加油！	下一站传奇	0
因为二爷在蕊蕊面前智商为零	蕊蕊	0
e魏莱被陈念手误给杀了，小北背的黑锅	小北	0
吴亦凡边伯贤吴世勋老公啊啊啊我害怕	吴世勋	0
说王源的是假粉丝吧，这是王俊凯	王源	0
高畅祝你幸福	高畅	1
孔雪儿！！！	孔雪儿	0
小王有点像汤唯，有点神似	小王	0
刘令姿加油！！！	刘令姿	1
没有想象中那么惊心动魄，6块钱为张涵予和袁泉	袁泉	1
喻言喻言啊啊啊啊	喻言	1
35岁李金铭，娄艺潇32	娄艺潇	0
冰化成水也不就能下雨吗？不过我就纳闷儿了，天上为什么丢下l￼哪吒留言？	哪吒	0
牛逼哪吒牛逼啊，哪吒去丙并￼	哪吒	1
林小宅太好看啊了	林小宅	1
敖丙，哪咤？申公豹，好傻	申公豹	0
希望屏幕前的各位投下徐轸轸，王承渲，陈品瑄	陈品瑄	1
可现实生活中的陈念没有小北啊	陈念	0
要是没有路垚乔楚生一个案也破不出来还探长呢剧情需要	乔楚生	0
我想看金子涵，不想看安琪，整天的努力人设!悲情人设	安琪	-1
许佳琪好帅哦	许佳琪	1
林宥嘉听邓紫棋的歌	邓紫棋	0
申洁也是她姐耽误了了	申洁	0
张新成镜头好少	张新成	-1
戴燕妮我可以！！	戴燕妮	1
说实话不太喜欢王欣宇她很但是不适合女团	王欣宇	-1
我认为申洁比较适合中心位，毕竟人家有亮点嘛，适合抓住别人的眼球	申洁	1
为毛毛打call	毛毛	1
王思予的高音可啊	王思予	1
王清好像阿沁王清媛啊，名字也像！！！	王清媛	0
许杨玉琢好撩	许杨玉琢	1
李现肖战候明昊王鹤棣敖瑞鹏张云龙胡一天保护我	肖战	0
许佳琪冲啊！	许佳琪	1
这哪吒和我一样消极哈哈	哪吒	0
艾莎唱歌好好听	艾莎	1
安娜要听艾沙的话	安娜	0
孔雪儿一天到晚只会内涵别人	孔雪儿	-1
伍佰老师又出现了	伍佰	0
许佳琪许佳琪	许佳琪	0
啊啊啊啊啊啊啊啊啊啊啊啊啊啊啊啊啊啊啊啊啊王承渲给我冲冲冲	王承渲	1
蔡徐坤演的不错	蔡徐坤	1
国王做是错的，反而让艾莎会越来越有自闭症	艾莎	0
哪吒好可爱。	哪吒	1
那孔雪儿就不是首A啊！为什么宣传是首A	孔雪儿	0
孔雪儿给我下蛊了吗杀了我吧太美了	孔雪儿	1
李现肖战候明昊王鹤棣敖瑞鹏张云龙胡一天保护我	胡一天	0
！安崎！实力全能ACE🍒爆炸小甜心❗️舞台小钢炮🌶️重庆辣妹！安崎宝贝冲！来pick安崎吧！！！	安崎	1
孔雪儿孔雪儿冲呀	孔雪儿	1
金子涵金子涵金子涵金子涵金子涵金子涵金子涵金子涵冲鸭	金子涵	1
因为庆帝觉得他娘功高盖主	庆帝	0
安崎不要慌，加油！！	安崎	1
不是针对就孔雪儿这样也叫舞蹈实力强？你确定没搞错吗	孔雪儿	-1
哈哈哈哈哈哈哈哈哈哈哈蔡徐坤会说话就多说点	蔡徐坤	1
立马解决，喻言肯定不是天秤座	喻言	0
申洁没毛病，那几个姐姐搞得两个人都压力大	申洁	0
我觉得申洁还行真的	申洁	0
开头是谁说的，最后有王一博的😞	王一博	0
神秘的美少女是娜美吧？话说娜美真的很美。	娜美	1
邓紫棋唱歌难听人做作	邓紫棋	-1
好希望任嘉伦来	任嘉伦	1
杨迪给腾哥揉腿那下好暖	腾哥	0
白幼宁好烦啊	白幼宁	-1
留个名，陆小凤，四条眉毛的陆小凤	陆小凤	0
周冬雨，二十八了，演技真好	周冬雨	1
坤哥就是太温柔了	坤哥	1
想起威基基里的瑞贝卡	瑞贝卡	0
第一名花花，第二名不是毛毛就是周深，能感觉到的，因为太好听了，就是有实力	周深	1
孔雪儿孔雪儿孔雪儿	孔雪儿	0
那个海军同意克比入伍也算是还路飞人情吧	克比	0
王俊凯，爱了	王俊凯	1
徐紫茵冲啊！	徐紫茵	1
怎么不请花泽香菜来！	花泽香菜	0
我爱这歌我爱华晨宇	华晨宇	1
申清好像还说了一句艹	申清	0
我看杨迪这段很搞笑后面他就没怎么说话了，沈腾的扔保龄球画面太啰嗦一点都不搞笑故意捧着太假	沈腾	-1
哪吒分明是好人为什么要打他？	哪吒	0
孔雪儿不怎么样啊，get不到	孔雪儿	-1
哪吒家有。他是孙公公。	孙公公	0
孔雪儿，美到爆炸！！	孔雪儿	1
毛毛走了不看了	毛毛	0
范丞丞范丞丞范丞丞范丞丞范丞丞范丞丞范丞丞范丞丞	范丞丞	0
丽萨太烦人了，让人极度不舒适，已举报！！！不用谢我	丽萨	-1
长公主的假毛，感觉不怎么合适呀	长公主	0
陈珏有点像Yamy	陈珏	0
升腾跟贾玲真的很幽默，综艺笑点多	贾玲	1
许佳琪好好老气a	许佳琪	-1
喻言又美又聪明	喻言	1
金子涵一看就是家教良好的女孩子	金子涵	1
毕竟是和杨洋并列的校草嘛哈哈哈	杨洋	1
王新宇真的欣赏不来	王新宇	-1
坤坤比较喜欢张总	张总	0
申冰真不要脸	申冰	-1
老秦护体神功	老秦	0
熊钰清和刘耀文一起跳过舞啊啊啊啊她是IM的导师	刘耀文	0
嘴型是乔楚生啊	乔楚生	0
王思予王思予王思予	王思予	0
刘令姿真的好气质	刘令姿	1
我超级喜欢华晨宇	华晨宇	1
申洁就还行啊，那个申冰一直作妖，吐了	申冰	-1
金子涵安崎孔雪儿冲啊啊啊啊	安崎	0
金子涵金子涵	金子涵	0
申洁比她的姐姐好点	申洁	1
加油，宋小宝	宋小宝	1
实力vocal王思予实力vocal王思予实力vocal王思予实力vocal王思予，豆包冲啊！！！！	王思予	1
哟这里是AKA秦牛正威	aka	0
安娜要死了，我饶一不了王子	安娜	0
看不懂的移步隔壁oxlxs看看陈立农前辈的初评级，别整天就蔡徐坤太宽，张艺兴他们不也给陈立农了个a	陈立农	0
周冬雨演技还是不错的	周冬雨	1
孔雪儿鼻孔好出戏	孔雪儿	-1
陈道明真的好牛逼	陈道明	1
不喜欢杨迪别看滚出去不就行了	杨迪	0
我是学舞蹈的客观的说孔雪儿这个舞蹈和许佳琪的舞蹈难度不是一个水平的没什么可比性	许佳琪	0
申冰嗓子被宝鹃下药了？	申冰	0
金子涵出道金子涵出道金子涵出道金子涵出道金子涵出道金子涵出道金子涵出道金子涵出道金子涵出道金子涵出道	金子涵	1
一直想看的哪吒上映了	哪吒	1
王欣宇好有周深的感觉啊	周深	0
白幼宁真恶心	白幼宁	-1
太乙真人被黑的最惨的一次阿，跟猪八戒一样啊，	太乙真人	0
你只抓住了申冰的眼球抓不住Lisa的眼球啊	申冰	0
最后看到小北也在就好了	小北	0
龙王望子成龙，这两家都不容易呀，好心疼	龙王	0
申洁你要有自知之明谢谢。言下之意你不配	申洁	-1
孔雪儿感觉有点冷漠	孔雪儿	-1
喻言爱死你啦	喻言	1
垃圾黄霄云，毛毛最棒	黄霄云	-1
突然喜欢蔡徐坤了	蔡徐坤	1
是他是他是李渔	李渔	0
孔雪儿长得好像老鼠	孔雪儿	-1
魏辰啊啊啊啊yg的必须强	yg	1
蔡卓宜好好看	蔡卓宜	1
蔡卓宜！！！！！！蔡卓宜！！！！！！！！！！！	蔡卓宜	1
孔雪儿必须是门面	孔雪儿	1
大哪吒去哪了？	大哪吒	0
还是那句话，蔡卓宜加油	蔡卓宜	1
萧敬腾！！！！	萧敬腾	0
小刘同学该吃夜宵啦！！	小刘	0
安琪是真厉害	安琪	1
毛毛已经抖动了，我就是来唱歌，要这么玩大南了😜	毛毛	0
左卓左卓左卓冲啊！	左卓	1
以前的吕小布有多渣现在的吕子乔就有多深情	吕小布	-1
我的天！安崎力量完爆！	安崎	1
曾可妮冲冲冲	曾可妮	1
艾莎公主真漂亮！！！	艾莎	1
蔡徐坤这次决定很不错	蔡徐坤	1
王承渲A暴了💗💗💗💗💗💗💗💗💗💗💗💗	王承渲	-1
太乙真人拿的是哪吒，申公豹拿的是敖丙	哪吒	0
杨迪知识量挺多的，平时应该很努力	杨迪	1
袁娅维比较高级很多	袁娅维	1
哪吒也太好看了。	哪吒	1
蔡卓宜冲冲冲！！	蔡卓宜	1
戴燕妮和蔡卓宜是同一批粉丝吗哈哈哈哈哈哈哈哈	蔡卓宜	0
李小冉皮肤真好	李小冉	1
傻逼白幼宁快死吧	白幼宁	-1
何美延抄袭道歉！！	何美延	-1
孔雪儿真的不配A,比她好的太多了	孔雪儿	-1
申洁还有镜头？	申洁	0
为什么孔雪儿是A呢，想不通	孔雪儿	-1
！！蔡卓宜我好粉！	蔡卓宜	1
蔡徐坤棒棒哒	蔡徐坤	1
申冰作妖老大！！！	申冰	-1
安崎表情！！！绝了！！	安崎	1
这是那天发现陈念没说的那个人	陈念	0
肖战糊穿地心了	肖战	-1
张总有点像王源	王源	0
申清说了句艹	申清	0
SNH48黄婷婷	snh48	0
许佳琪真的好好看嘤	许佳琪	1
卡点有点像张艺兴	张艺兴	0
敖丙是银河奥特曼哪吒是维克特利奥特曼	敖丙	0
冲啊金子涵冲冲冲！	金子涵	1
你们的基金张伟也有股份😂😂😂	张伟	0
这么多集，都不见曾小贤呢！不会被人遗忘了吧	曾小贤	0
孔雪儿到底有什么脸说自己练了八年啊，八年就这水平？	孔雪儿	-1
啊啊啊啊啊陈珏！	陈珏	0
许佳琪❤️❤️❤️❤️❤️❤️❤️❤️	许佳琪	1
他妈杨迪好烦	杨迪	-1
金子涵金子涵金子涵金子涵冲冲冲	金子涵	1
魏辰魏辰魏辰魏辰魏辰————！！！！！	魏辰	0
张总，小王加油！	小王	1
35岁李金铭，娄艺潇32	李金铭	0
感觉牧尘会被骗😂	牧尘	0
金子涵总让我想到周子瑜	周子瑜	0
徐锦江，是你吗？这里是流沙河吗？	徐锦江	0
孔雪儿的A太水了吧	a	0
我死了啊啊啊啊啊啊啊啊啊啊啊啊啊刘令姿太A了	刘令姿	1
一群假粉丝海王俊凯，这明明是易烊千玺	俊凯	0
为什么？？？天哪无语了明明只有王承渲最好到底怎么投票的啊	王承渲	1
其实申洁还好，关键那几个不懂事的姐姐	申洁	0
浪里小白龙吕子乔	小白龙	0
金子涵来点经呕吐啊	金子涵	-1
小五说英语也太好听了吧!!!!!	小五	1
徐轸轸也是个不错的姑娘啊，当时还帮wcx妹妹说话来着，大家也可以帮她投投票哦	徐轸轸	1
王承渲不在c也是坠棒的！	王承渲	1
我最好的淘宝是是我最好的朋友，他最喜欢看哪吒之魔童	哪吒	0
真的是欠周冬雨和易洋千玺一张电影票	周冬雨	1
赵小棠加油大鱼海棠大鱼海棠	大鱼海棠	0
说孔雪儿好看的是瞎了吧？哪里好看了？龅牙妹	孔雪儿	-1
蔡卓宜加油！	蔡卓宜	1
许佳琪快本三个字真是印象深刻啊呕	许佳琪	1
蔡徐坤我爱你我爱你啊啊！！！！！	我爱你	1
孔雪儿恶心算了，恶	孔雪儿	-1
喻言妈妈来了	喻言	1
徐轸轸徐轸轸徐轸轸、	徐轸轸	0
那不是李靖么？咋变姜子牙了	李靖	0
态度很明显了，就喜欢这样子把话说的明白点，怎么就还有脸待在C位，你申洁觉得自己不配你自己没长嘴巴不会说还是觉得自己做的挺好的了？	申洁	-1
有为了欧豪来的吗	欧豪	1
王承渲加油鸭	王承渲	1
刷秦牛的傻逼吗，认错人了不知道吗？秦牛正威还没出来	秦牛正威	0
刘令姿冲鸭！	刘令姿	-1
陈珏这个发型好像小马宝莉的星光熠熠	陈珏	0
徐天啊！怎么不带田丹一起	田丹	0
安琪的solo不是播过了吗	安琪	0
敖丙是银河奥特曼哪吒是维克特利奥特曼	维克特利奥特曼	0
刘令姿！！！天鹅姐姐冲啊！！	天鹅姐姐	1
张艺兴的粉丝脸好大哦真的很招黑知道吗？	张艺兴	-1
任达华和徐锦江友情出演	任达华	0
-1乐华】🍓-1宋昭艺】🍒𝙋𝙄𝘾𝙆宋昭艺入股不亏🍒	宋昭艺	1
亚楠像孙燕姿	亚楠	0
发型师是托尼老师的徒弟吗	托尼	0
黄小芸＾０＾~加油	黄小芸	1
韩雪的妈妈长得好像林心如	林心如	0
我觉得王承渲不应该就这么一点儿票	王承渲	0
啊啊啊啊魏辰魏辰魏辰魏辰	魏辰	1
啊！我太爱毛毛了！我来就是看毛毛和花花的	毛毛	1
坤哥真相了！！！	坤哥	0
安娜吃药了没？	安娜	0
那陈念也进去了？	陈念	0
特不喜欢杨迪	杨迪	-1
太乙你救了我一命哪吒：太乙你救了我一命	太乙	0
啊啊啊啊许佳琪你值得呜呜呜呜呜呜	许佳琪	1
孔雪儿做什么都是错的好吧	孔雪儿	0
谢可寅你要控制你自己	谢可寅	0
谢可寅也来了，好多出道过的歌手加油	谢可寅	0
林小宅超级好看	林小宅	1
喻言好霸道我好爱	喻言	1
莎莎妈妈爱你	莎莎	1
牧尘他喜欢的就是你媳妇呀	牧尘	0
周深和毛毛真的爱了	毛毛	1
王思予王思予！！！	王思予	0
不喜欢韩雪别说，影响观看体验，真没素质	韩雪	0
熊钰清是里面隐藏的王者dancer	熊钰清	1
哪吒是个球？	哪吒	0
蔡卓宜给我冲	蔡卓宜	1
敖丙是银河奥特曼哪吒是维克特利奥特曼	银河奥特曼	0
葛欣亿好像郑爽	葛欣亿	0
申冰不是退赛了，为什么还有她的镜头？	申冰	0
金子涵金子涵金子涵金子涵	金子涵	0
刚才魏辰一瞬间有点像金请夏	魏辰	0
哪吒裤子又没有口袋，手放哪里人呢？	哪吒	0
蔡卓宜确实有观众缘，长得甜美	蔡卓宜	1
金子涵啊啊啊啊啊！！！	金子涵	1
虞书欣冲鸭！！！！！	虞书欣	1
啊啊啊啊啊KIKI！许佳琪！仙女❤️	kiki	1
吧唧和路飞一直打	路飞	0
天啊啊喻言什么时候出来啊急死我了	喻言	0
金子涵魏辰！！	金子涵	0
哈哈哈好可爱文哲	文哲	1
哪吒性格随了娘，哈哈	哪吒	0
蔡卓宜。我爱你。哈哈哈哈。加油	蔡卓宜	1
林小宅可以啊	林小宅	1
跪求请林俊杰来啊啊啊啊啊啊啊	林俊杰	1
宝贝大佬康康爱宝贝大佬林鹿	林鹿	1
弹幕别烦了好吗安崎实力好不好导师会看。说别人用力过猛这舞蹈本来就这样的吧而且安崎如果实力不好lisa也不会夸她	安崎	0
对不起啊！哪吒	哪吒	0
戴燕妮戴燕妮戴燕妮	戴燕妮	0
林小宅太可爱了	林小宅	1
虞书欣虞书欣冲啊	虞书欣	1
欢迎密码，你用心，你敏敏婆，魔攻，神龙龙大哪吒，小哪吒，刚生出来的小哪吒，奥比太乙真人。	哪吒	0
听毛毛的就是走进心里没有太多的表面爆发好吧	毛毛	0
白幼宁让人讨厌	白幼宁	-1
感觉看他们三个比看哪吒还感动	哪吒	0
华晨宇全场沸腾	华晨宇	1
王思予冲呀！！	王思予	1
这句软肋让我想到了陆绎	陆绎	0
葛鑫怡加油啊	葛鑫怡	1
林小宅可真好看，仙女啊	林小宅	1
张天爱台词不太行啊	张天爱	-1
张总其实也不错，小王真的好好笑哦	张总	1
陈楚生：他胆小我得护着他	陈楚生	0
何美延抄袭，再见吧	何美延	-1
这个舞台需要有爆发力的歌手，毛毛确实不适合生存	毛毛	0
蔡卓宜怎么就不行	蔡卓宜	-1
蕊蕊咋那么爷们呢	蕊蕊	0
刘令姿美绝！！！	刘令姿	1
牧尘情敌和你袒露心声呢	牧尘	0
小说里陈念是个小结巴	陈念	0
陈奕迅什么时候来呀？	陈奕迅	0
刘令姿又鲨我了	刘令姿	1
孔雪儿加油呀	孔雪儿	1
这是我爱上周深的舞台！！！	周深	1
刘令姿刘令姿刘令姿❤️❤️❤️	刘令姿	1
王源和王俊凯演得真好	王源	1
过了，陈念这个举动过了	陈念	0
你们搞清楚啊，戴萌就是直播玩PD梗的那个	戴萌	0
左卓左卓左卓左卓	左卓	0
然后变成哪吒拯救了敖丙和龙族吗	哪吒	0
突然想看王嘉尔	王嘉尔	1
张伟：我是车神	张伟	1
孔雪儿脖子又粗，牙又大，哪里好看了	孔雪儿	-1
毛毛好像整牙了	毛毛	0
哇哈哈哈哈哈哈关晓彤太可爱了吧	关晓彤	1
是凌玲吗？胖了	凌玲	0
林凡林凡林凡宝贝冲冲冲	林凡	1
小爷哪吒真厉害。	哪吒	1
莫非是叶凡在渡劫，天庭显现了	叶凡	0
王源，范世琦，贾乃亮保护我	贾乃亮	0
喻言啊啊啊啊	喻言	1
蔡卓宜你是坠棒的！	蔡卓宜	1
魏辰宝贝好棒	魏辰	1
张伟已经开车1小时了	张伟	0
孔雪儿长得就是哈哈哈	孔雪儿	0
讨厌,王一博我让你抱着我,你往哪儿摸呢.啊啊啊啊	王一博	0
申洁跳的那什么玩意儿？	申洁	-1
哎，就不能本来就这么好看吗，张予曦也是，真的很好看啊	张予曦	1
葛鑫怡葛鑫怡葛鑫怡葛鑫怡葛鑫怡葛鑫怡	葛鑫怡	0
华晨宇？！啊啊啊啊啊啊啊	华晨宇	1
煞笔肖战粉，你们还敢刷吗，肖战是我儿	肖战	-1
我哭了刘令姿真的很棒很棒	刘令姿	1
虞书欣你妈的真是装	虞书欣	-1
刘雨昕刘雨昕	刘雨昕	0
杨迪跟个傻逼一样	杨迪	-1
披金斩棘不畏涵霜金子涵金子涵金子涵金子涵冲鸭披金斩棘不畏涵霜金子涵金子涵金子涵金子涵冲鸭！	金子涵	1
我觉得最后来一个小北和陈念的结婚照更好，让结局更加完美	陈念	0
小爷好可爱我好喜欢看看哪吒知道个什么呀	小爷	1
文哲憨憨的，哈哈哈，可爱	文哲憨憨	1
规则也没说，我不能嫁给关晓彤呀，也没说你不是个傻子	关晓彤	0
第一，花花，第二应该是米希牙，第三有雨神，不喜欢周深的声音	雨神	0
喜欢贾乃亮，谦虚低调，真好	贾乃亮	1
我感觉鬼灵子是真心喜欢洛璃	洛璃	0
大家看看黄小芸！！！！！！！谢谢各位爹地妈咪了！！！！！	黄小芸	1
其实申洁应该做leader，因为大部分人都听她的	申洁	0
安崎和蔡卓宜的不同就在于有颜值靠颜值没颜值看实力	安崎	0
金子涵和安琦好搭	安琦	1
你不投我不投，雪儿是A也出不了头	雪儿	-1
许佳琪，许佳琪，许佳琪	许佳琪	0
毛毛懵了hhhhhhh	毛毛	0
可是蔡卓宜不是北电的她的介绍说自己是北电的就有点觉得虚荣	蔡卓宜	-1
太乙你救了我一命哪吒：太乙你救了我一命	哪吒	0
刘令姿刘令姿	刘令姿	0
张语格不是这组别ky	张语格	0
金子涵又高又好看	金子涵	1
小北放开那女孩，冲我来！	小北	0
秦牛正威长得也不好看啊	秦牛正威	-1
这样扭会不会腰间盘突出这组太猛了孔雪儿加油	孔雪儿	1
蔡卓宜笑起来太像张予曦了	张予曦	0
快去关注我们安崎的wb！	安崎	1
尹正下一个角色:贾宝玉	尹正	0
刘令姿刘令姿刘令姿刘令姿刘令姿刘令姿刘令姿刘令姿	刘令姿	0
徐轸轸徐轸轸徐轸轸、	徐轸轸	0
大力是胡一菲培养的接班人	胡一菲	0
好多邓紫棋的歌	邓紫棋	0
孔雪儿真的不争不抢安安静静很内向	孔雪儿	1
林宥嘉~我的秘密？	林宥嘉	0
我恨你申公豹	申公豹	-1
刘令姿还跳了一下太可爱了	刘令姿	1
期待喻言和左卓	左卓	1
杨迪好作，明显就是故意的	杨迪	-1
魏辰！！！！	魏辰	0
小棠第3了哈哈	小棠	0
人狠话不多！就靠实力！安崎好样的！！！！	安崎	1
蔡卓宜真的太甜了！！	蔡卓宜	1
我感觉哪吒的师傅好丑啊！！😨😨😨😨	哪吒	0
申公豹，你怎么会知道这个？	申公豹	0
喜欢袁娅维加油加油	袁娅维	1
丽萨借要帮小贤除草啦	小贤	0
你们见过刚出生的孩子就有头发吗？没错，就是哪吒	哪吒	0
下部是姜子牙	姜子牙	0
虞书欣镜头怎么这么多	虞书欣	0
许佳琪努力向前加油！！我们在你身后陪着你！！	许佳琪	1
许佳琪太酷了爱了爱了	许佳琪	1
许佳琪冲啊！	许佳琪	1
前面说鞠婧祎的，崽儿可能真的在看😹😹😹	鞠婧祎	0
蔡徐坤大实话	蔡徐坤	0
喻言宝贝一定要出道呜呜呜	喻言	1
好好看蔡卓宜	蔡卓宜	1
我感觉她在让申洁	申洁	0
韩雪妈妈笑死了有点像林心如	韩雪	1
万能小黑啊，你去手机店找人帮你解锁啊	小黑	1
范爸穿的什么？波力海苔？	范爸	0
萧敬腾杨坤羽泉张杰都是最美和声的导师！	张杰	0
陈，，，陈坤？	陈，	0
不是说这个电影里有王一博，么	王一博	0
奇袭毛毛的是心机婊	毛毛	0
孔雪儿孔雪儿孔雪儿孔雪儿孔雪儿	孔雪儿	0
求一个葛鑫怡的美瞳链接	葛鑫怡	0
蔡卓宜的脸让我想整容	蔡卓宜	-1
这不是马苏啊，为什么都认错	马苏	0
我也觉得孔雪儿脖子粗	孔雪儿	-1
蔡卓宜太可了	蔡卓宜	1
陈总，接下来还有哪部	陈总	0
戴燕妮谢可寅刘雨昕黄小芸金子涵刘亚楠王承渲安崎赵小棠	刘雨昕	0
奇袭毛毛的真丑	毛毛	0
虞书欣嘞？？？	虞书欣	0
嗷嗷嗷嗷嗷嗷！！！顺子太可爱啦！！！！！	顺子	1
冰清玉洁什么鬼啊！王承渲加油！	王承渲	1
长公主还是很厉害的，不过和陈萍萍比嫩了点，动范闲你不怕陈萍萍吗	范闲	0
陈品瑄更抓眼球谢谢	陈品瑄	1
文哲有点颖儿的感觉	文哲	0
魏辰给姐火！！	魏辰	1
听到这句话，就晓得柳慕白没问题了	柳慕白	0
张总其实也不错，小王真的好好笑哦	小王	1
华晨宇华晨宇华晨宇华晨宇	华晨宇	0
哪吒的样子好拽啊	哪吒	0
徐紫茵实力超强的！	徐紫茵	1
说的是乔楚生	乔楚生	0
左卓左卓左卓冲啊	左卓	1
许佳琪solo抄袭韩国舞室alien的舞蹈！！	许佳琪	-1
我啥时候看你的演唱会呀蔡徐坤？	蔡徐坤	0
安崎，给老子出道！	安崎	1
王俊凯你倒是上啊	王俊凯	0
魏辰魏辰魏辰魏辰魏辰魏辰魏辰魏辰魏辰！	魏辰	0
一位不愿透露姓名的彭于晏路过	彭于晏	0
萧敬腾杨坤羽泉张杰都是最美和声的导师！	羽泉	0
林小宅好A啊！！！！！！！	林小宅	1
安崎吃啊吃啊吃啊	安崎	0
最终一群人放弃了张伟的车😂😂	张伟	0
世界欠我一个小北	小北	1
每个人生想要怎么活都是自己决定的，蔡卓宜活出了自己，加油加油加油！	蔡卓宜	1
宋江都准备开飞机了	宋江	0
徐紫茵谢可寅许馨文都是下一站传奇的宝藏妹妹！！！！	谢可寅	1
你一票我一票明天蔡卓宜就出道	你一	0
王承渲加油加油	王承渲	1
这样也很不错了，只判四年，如果小北一个人要监狱蹲十几年	小北	0
还以为是小李子	小李子	0
徐紫茵正片一剪梅厦门双十的学霸姐姐！pick她！	一剪梅	0
戴燕妮挺强的	戴燕妮	1
王思予也太美了啊啊	王思予	1
哪吒血亲只有敖丙	哪吒	0
蕊蕊白的发光了哈哈哈哈	蕊蕊白	1
秀儿，他喵的是你吗	秀儿	0
留名黑龙江陈冠希	陈冠希	0
大爱王俊凯！！！！！王俊凯演的太好了	王俊凯	1
这么多白骨精？悟空沉默了	白骨精	0
赵小棠我真的爱了爱了	赵小棠	1
我的周深是真的矮哈哈	周深	0
蔡徐坤很可爱的	蔡徐坤	1
啊啊啊啊刘令姿你值得	刘令姿	1
刘令姿成都妹子值得入股	刘令姿	1
蕊蕊眼睛👀瞪的像铜铃	蕊蕊	0
拽拽的哪吒好可爱	哪吒	1
林宥嘉听邓紫棋的歌。。	林宥嘉	0
孔雪儿是赚了有粉丝基础而已实力真的太一般	孔雪儿	-1
我也看到了乔楚生！	乔楚生	0
哪吒生出就是	哪吒	0
这不是相当于把范闲身份告诉他了？	范闲	0
孔雪儿不配出道	孔雪儿	-1
蔡卓宜真的是整容脸啊	蔡卓宜	-1
哪吒不要哭了	哪吒	0
吴亦凡边伯贤吴世勋老公啊啊啊我害怕	吴亦凡	0
Lisa:虽然曾小贤长的丑啥也不是，但你也不能绿她呀	曾小贤	0
那么多说明星的就肖战一家得罪你了，双标	肖战	0
华晨宇❤️❤️❤️❤️	华晨宇	1
宝贝蔡卓宜去solo出道吧！	蔡卓宜	1
许佳琪粉丝别捧一踩一	许佳琪	1
左卓左卓左卓左卓	左卓	0
赵小棠加油大鱼海棠大鱼海棠	赵小棠	1
陈昕葳金子涵加油	金子涵	1
蔡徐坤跟吴亦凡有点撞脸	吴亦凡	0
不喜欢白幼宁是男主的粉吧？	白幼宁	-1
蔡卓宜啊啊啊啊啊啊啊啊啊啊	蔡卓宜	1
喻言！！！喻言喻言	喻言	0
啊啊啊啊啊啊啊啊啊刘令姿	刘令姿	1
林小宅是真好看！	林小宅	1
说商菊贞的怕是傻子吧！侯玉魁都说了当时是和商菊贞，宁九郎，姜荣寿同台的时候偷听到的。	宁九郎	0
宝藏女孩陈珏，爱死了	陈珏	1
谢可寅冲冲冲！！！	谢可寅	1
还要强行洗白孔雪儿不知道在想什么	孔雪儿	0
喻言大帅哥出道吧	喻言	1
大家看看王思予吧！！！！！！！！	王思予	0
看肖战的可以滚了	肖战	-1
陈珏陈珏陈珏！！！！	陈珏	0
孔雪儿有点可爱啊哈哈哈哈哈哈哈	孔雪儿	1
虞书欣虞书欣加油虞书欣虞书欣加油虞书欣虞书欣加油	虞书欣	1
刘令姿啊啊啊啊啊	刘令姿	1
每一次黄晓明的眼神都能惊艳到我	黄晓明	1
拉拉和毛毛都是抒情歌，比较吃亏	拉拉	0
喻言冲啊啊啊啊啊啊	喻言	1
牧尘像个狗似的	牧尘	-1
所以王思予和魏辰真的太难了，而且她两真的很优秀，但是没媒体资源	王思予	0
口型是乔楚生啊	乔楚生	0
坚持十年，从不放弃，戴燕妮，fighting!	戴燕妮	1
白傻逼吧，演技也不行，别说小青演的好，真不怎么样	小青	-1
许杨玉琢冲冲	许杨玉琢	1
哪吒不是还能活两年吗	哪吒	0
我讨厌白幼宁！！！！！	白幼宁	-1
孔雪儿谢可寅冲冲冲	孔雪儿	0
周雅文怎么了？	周雅文	0
臭老头不要伤害牧尘	牧尘	0
希望娜扎不会对这么狠	娜扎	0
林小宅是哪一个	林小宅	0
小红袄来了徐天	徐天	0
许杨玉琢表情可以的	许杨玉琢	1
张总是厉害一些	张总	1
能在自己的领域有闪光点的那些人身上，会有着不一样的地方的，对林小宅刮目相看了	林小宅	1
王思予没镜头啊啊啊啊	王思予	0
路遥睡得好香	路遥	0
许佳琪牛逼，姐姐我死了	许佳琪	1
徐紫茵爱了爱了	徐紫茵	1
李小冉很合适啊！！！工于心计艳绝天下的长公主！	长公主	1
没人夸黄欣苑嘛	黄欣苑	0
只有我没get到孔雪儿的颜吗？	孔雪儿	0
那不是李靖么？咋变姜子牙了	姜子牙	0
肖战粉丝死远点	肖战	-1
讨厌冰清玉洁，支持王承渲	冰清玉洁	-1
陈念只要你回头我一直都在	陈念	0
张建龙我喜欢你	张建龙	1
王清加油冲鸭！！！！	王清	1
金子涵大长腿啊啊啊	金子涵	1
杨迪能听见啊不然怎么知道自己先说服了	杨迪	0
对林小宅改观	林小宅	1
金子涵孔雪儿都超好的	金子涵	1
蔡卓宜太甜了呜呜呜呜呜	蔡卓宜	1
小北是不是被认成嫌疑犯了	小北	0
有没有觉得她很像金锁时期的范冰冰	范冰冰	0
哪吒不是坚不可摧吗？	哪吒	0
金子涵真的颜霸	金子涵	1
向刘长健致敬	刘长健	1
庆帝本来就是很睿智1.	庆帝	1
别问了，孔雪儿充钱了	孔雪儿	-1
这一季最漂亮蔡卓宜	蔡卓宜	1
王承渲冲啊！！！！！！！加油真的好爱你	王承渲	1
哈哈哈哈哈刘雨昕刘令姿我的最pick	刘雨昕	1
希望这次夸七岁好听的不是上次夸那个蔡卓宜的，只能选一个哦	蔡卓宜	0
小北看到小孩子被逼迫偷钱就打了那些混混结了怨，小北是善良的人	小北	1
我的安崎啊啊啊啊啊啊啊啊啊啊啊啊啊啊啊啊啊啊	安崎	1
当着林宥嘉面唱邓紫棋歌	邓紫棋	0
小太阳我只认林杨	林杨	0
这个申洁表情管理一级差	申洁	-1
葛鑫怡葛鑫怡葛鑫怡！！！！	葛鑫怡	0
我最讨厌申冰，申洁还好，申冰眼睛有泡吧。。	申冰	-1
徐紫茵唱的好好听啊！！	徐紫茵	1
真的不适合，现在还好意思说我们让还C位，得了吧，要是C位像蔡徐坤那样还能黑你？	蔡徐坤	0
林小宅这个辫子辫进我的心里了	林小宅	1
秦牛正威不就谈了个恋爱吗为什么都骂他	秦牛正威	0
杨迪很可爱啊	杨迪	1
郑易是对的，这样真的对谁都好，至少两个人都活着	郑易	1
申冰的喋音真的恶心到了	申冰	-1
艾玛，这结巴得	艾玛	0
曾可妮演过惹不起的殿下大人里面一个异国公主	惹不起的殿下大人	0
弹幕好多杠精，服了，蔡卓宜很努力很好看好吧	蔡卓宜	1
安崎啊啊啊啊啊啊啊啊啊啊啊	安崎	1
大力是彩色的张伟是灰色的	张伟	0
自我介绍下，各位，我叫大炮，以后请叫我炮哥	炮哥	0
听，那是什么声音？那是黄晓明的磨刀声，他以在我这买了火箭票。	黄晓明	0
王清！！！！陈珏！！！	王清	0
实力vocal王思予实力vocal王思予实力vocal王思予实力vocal王思予，豆包冲啊！！！！	王思予	1
文哲好像颖儿	颖儿	0
拉子姐是薛之谦附体了吗	薛之谦	0
都比孔雪儿好太多了……	孔雪儿	-1
冯若航学姐冲冲冲冲冲冲冲冲冲冲冲冲冲冲冲冲冲冲冯若航冯若航冯若航冯若航冯若航冯若航冯若航冯若航	冯若航	1
女娲拿来抓袁洪的山河社稷图	女娲	0
蔡徐坤太好了	蔡徐坤	1
李阳最帅，何小平最丑	何小平	-1
这是不是秦牛正威那一个	秦牛正威	0
坐等全能女王喻言	喻言	1
蔡卓宜蔡卓宜！	蔡卓宜	0
跟咖喱酱没关系，就是美嘉自己作的，悠悠还和张伟拥抱过呢	张伟	0
刘雨昕出道吧	刘雨昕	0
熊钰清是哪位	熊钰清	0
妈呀，哪吒这次要断子绝孙啊！	哪吒	0
前面说许佳琪不自然的，丝芭那么严，钱还少，她哪有钱去整容	丝芭	0
孔雪儿小3必糊哦	孔雪儿	-1
这哪吒一点不值得看	哪吒	-1
申请把申冰打马赛克	申冰	-1
孔雪儿好歹以前是jpy的实力能很差？说白了不就人品差吗	孔雪儿	-1
那孔雪儿哪是首A？	孔雪儿	0
欧豪后来可期	欧豪	1
周深和毛毛声音都独特	周深	1
赵小棠加油大鱼海棠大鱼海棠	大鱼海棠	0
喻言喻言加油	喻言	1
沈苍生早就可以当老师了，实力比很多老师都强了，只是舔着脸不毕业，跑任务赚钱钱罢了	沈苍生	0
本来还挺喜欢Ella老师的，但是这么说张溪杨蕊菡张楚寒就有一点过分了吧毕竟你在101还是很喜欢她们的	张楚寒	0
乔楚生！乔楚生！看唇形是乔楚生！	乔楚生	0
蔡徐坤蔡徐坤蔡徐坤蔡徐坤蔡徐坤蔡徐坤蔡徐坤蔡徐坤蔡徐坤蔡徐坤蔡徐坤蔡徐坤蔡徐坤蔡徐坤蔡徐坤蔡徐坤蔡徐坤蔡徐坤蔡徐坤蔡徐坤	蔡徐坤	0
感觉文哲有点像金所炫超好看	文哲	1
刘亚楠眼神有点深邃，好看啊	刘亚楠	1
王思予真的不错！👍	王思予	1
顺子不会也爱上蕊蕊了	蕊蕊	0
贾玲说不对的时候他耳机都没摘就换一个答案还和贾玲对话，这就假了吧	贾玲	0
我好爱肖战哥哥哥哥是我的全部	肖战	1
那个，没有其他意思，就是好奇蔡卓宜除了好看还有什么么	蔡卓宜	0
魏辰魏辰魏辰魏辰魏辰魏辰魏辰魏辰魏辰	魏辰	0
王承渲王承渲	王承渲	0
前面那个说张新成矮的你别走	张新成	0
蕊蕊不会是小阿哥吧	蕊蕊	0
汉斯王子好坏	汉斯	-1
刘令姿麻麻爱你！	刘令姿	1
孔雪儿整容过度了吧	孔雪儿	-1
哪吒好厉害🥰	哪吒	1
我李小璐离婚怎么了	李小璐	0
好假，虞书欣没有表演过就第一了	虞书欣	-1
许佳琪许佳琪许佳琪许佳琪许佳琪许佳琪许佳琪许佳琪许佳琪许佳琪许佳琪许佳琪许佳琪许佳琪许佳琪许佳琪++	许佳琪	0
申公豹你不能这样，看我今天我不打死你。申公豹你等着瞧😡😡😡	申公豹	0
徐紫茵！！！	徐紫茵	0
本来听得好有感觉，一看到马薇薇我喷了	马薇薇	-1
虞书欣也太可了	虞书欣	1
是剪辑原因吧孔雪儿当时应该还没拿a	孔雪儿	0
说王源的是假粉丝吧，这是王俊凯	王俊凯	0
林俊杰不年轻了	林俊杰	0
蔡徐坤爱你哟	蔡徐坤	1
坤哥的声音是被天使吻过把这么好听	坤哥	1
留个名宇智波佐助	宇智波佐助	0
孔雪儿孔雪儿孔雪儿孔雪儿孔雪儿爱死你了(๑°3°๑)	孔雪儿	1
说柳岩的请问你去过祖安大舞台么？柳岩吃你家大米了？	柳岩	0
认为欧豪声音很好听	欧豪	1
全程捕捉魏辰	魏辰	1
哈哈哈哈啊哈哈哈哈哈邓紫棋	邓紫棋	0
上一期杨迪还说要花钱请外国友人离开	杨迪	0
肖战是魔鬼么无论在哪都摆脱不了…	肖战	-1
哈哈哈哈哈哈哈哈，蔡徐坤厉害哈哈哈哈哈哈哈哈哈大实话	蔡徐坤	1
主要是申洁最后的空翻好加分……唉	申洁	0
长公主还是很厉害的，不过和陈萍萍比嫩了点，动范闲你不怕陈萍萍吗	陈萍萍	0
好讨厌周冬雨这个发型，更讨厌那个女警	周冬雨	-1
是他就是他我们的英雄小哪吒哪吒。	哪吒	1
肖战就是个垃圾！！	肖战	-1
这个修女是孙千吗	孙千	0
我寻思极限黄磊作弊也没见有人喷啊，娱乐节目，何必呢？	黄磊	0
喻言喻言冲鸭	喻言	-1
孔雪儿的A太水了吧	孔雪儿	-1
上官喜爱、安崎和许佳琪是真的可以Ａ	许佳琪	1
范思辙：不愧是我	范思辙	1
好男人就是吕子乔	吕子乔	1
申冰有点无语，别人指出你们的不足，不反思还狡辩	申冰	-1
王承渲一直走在中间，当然醒目啦，最后一幕我不信你没有记得申洁。	申洁	0
金子涵金子涵冲冲冲	金子涵	0
不接受孔雪儿洗白	孔雪儿	-1
孔雪儿也配出道？学艺先学德好吧？不尊重人，吊着嘉羿踹了马伯骞	孔雪儿	-1
蔡徐坤真相了	蔡徐坤	0
秦牛正威真无语	秦牛正威	-1
为什么两次游戏都没柳岩	柳岩	0
喻言喻言喻言冲冲冲	喻言	0
我觉得冰清玉洁最好的还是申洁，申洁比其他三个有自知之明，也比其他三个努力	申洁	1
安崎，安崎妈呀，我太喜欢，太喜欢，太喜欢了。	安崎	1
哪吒其实就是个很单纯的小孩子而已	哪吒	1
葛鑫怡葛鑫怡葛鑫怡葛鑫怡葛鑫怡葛鑫怡	葛鑫怡	0
戴燕妮声音好听	戴燕妮	1
你又不是李菁	李菁	0
琪琪我喜欢你	琪琪	1
陈珏陈珏陈珏！！！！	陈珏	0
许佳琪不如这三个	许佳琪	-1
太乙真人拿的是哪吒，申公豹拿的是敖丙	太乙真人	0
郭德纲演得好啊	郭德纲	1
肖战怎么啦，你们别黑战战不行吗	肖战	0
好喜欢胡博啊❤️❤️	胡博啊	1
不喜欢王新宇	王新宇	-1
她拍火凤凰之前就是范冰冰的替身	范冰冰	0
周深很棒啊~	周深	1
蔡卓宜是C?	蔡卓宜	0
李小冉很合适啊！！！工于心计艳绝天下的长公主！	李小冉	1
许佳琪！我超爱这姐	许佳琪	1
我龙哥最帅，最爱张云龙！	张云龙	1
跟咖喱酱没关系，就是美嘉自己作的，悠悠还和张伟拥抱过呢	美嘉	0
萧敬腾杨坤羽泉张杰都是最美和声的导师！	最美和声	0
欢迎密码，你用心，你敏敏婆，魔攻，神龙龙大哪吒，小哪吒，刚生出来的小哪吒，奥比太乙真人。	敏敏婆	0
李现李现李现	李现	0
魏辰魏辰魏辰	魏辰	0
李现肖战候明昊王鹤棣敖瑞鹏张云龙胡一天保护我	候明昊	0
葛鑫怡葛鑫怡葛鑫怡葛鑫怡葛鑫怡葛鑫怡葛鑫怡葛鑫怡葛鑫怡葛鑫怡葛鑫怡葛鑫怡葛鑫怡葛鑫怡葛鑫怡葛鑫怡冲冲	葛鑫怡	0
李子维黄雨萱	黄雨萱	0
这才是A该有的实力吧，说实话我看选秀节目从来没讨厌过哪一个选手，但就是这个孔雪儿莫名的感觉很厌烦	孔雪儿	-1
蔡卓宜小姐姐	蔡卓宜	0
乃万呢？？？？虞书欣呢？？？？？完了？	乃万	0
林小宅真的进步好大也不娇气，太棒了	林小宅	1
白真的不讨人喜欢......	白	-1
申冰会他妈说话吗	申冰	-1
文哲咋那么像颖儿捏？	颖儿	0
李现肖战候明昊王鹤棣敖瑞鹏张云龙胡一天保护我	李现	0
哈哈哈哈哈哈，坤哥好样儿的	坤哥	1
现在跟死了他亲妈一样，还不是因为魏莱家有钱	魏莱	0
卧槽段小薇这么丑我都没认出来	段小薇	-1
娜扎都已经没有今后了不过他还是有的	娜扎	0
蔡徐坤你真好，一天天的竟说大实话	蔡徐坤	1
这怎么跟晓彤和郑爽的冰雪奇缘不一样呢？	冰雪奇缘	0
说孔雪儿头发丝怕不是没见过罗捷头发丝吧	孔雪儿	0
坤哥太可爱了💛💛	坤哥	1
周冬雨杀的别问了，一点脑子都没，这个很好理解。	周冬雨	0
一直夸喻言我都赞不完了	喻言	1
许佳琪许佳琪许佳琪许佳琪许佳琪许佳琪许佳琪许佳琪许佳琪许佳琪许佳琪许佳琪许佳琪许佳琪许佳许佳琪许佳琪	许佳	0
我也想要牧尘哥哥那样的朋友	牧尘	1
表示不喜欢虞书欣	虞书欣	-1
可是，当张艺兴面对考核女团的人选，也是一样会松也伴着该有的评论，但是不会比向男团一样严格	张艺兴	0
魏辰魏辰魏辰魏辰魏辰魏辰魏辰魏辰魏辰	魏辰	0
申洁s掉算了	申洁	-1
一直都很喜欢贾玲，不过看了几集这季，太抢戏了	贾玲	-1
戴燕妮谢可寅刘雨昕黄小芸金子涵刘亚楠王承渲安崎赵小棠	安崎	0
杨过与小龙女寒潭相遇？	杨过与小龙女	0
哪吒要没有肉体了	哪吒	0
周深和毛毛声音都独特	毛毛	1
王承渲妈妈永远爱你	王承渲	1
王承渲冲冲冲	王承渲	1
蔡奎最后最后被中东女推进楼下然后被小北埋尸	蔡奎	0
看不懂的移步隔壁oxlxs看看陈立农前辈的初评级，别整天就蔡徐坤太宽，张艺兴他们不也给陈立农了个a	蔡徐坤	0
蔡卓宜实力不太行其实，说真的别喷我	蔡卓宜	-1
《潮流合伙人》下期才有王源！！！《潮流合伙人》下期才有源儿！！！	潮流合伙人	0
孔雪儿人品不行啊	孔雪儿	-1
许才是首A孔雪儿她不配	孔雪儿	-1
孔雪儿没脚踏两条船你们有病	孔雪儿	-1
这个王欣宇真是无力吐槽	王欣宇	-1
这部剧什么时候郭德纲赵本山成龙周润发刘德华他们出来，就为了看他们。。。。。。。。。。。。。。。。。	赵本山	0
安崎！！！！！！！！	安崎	1
喻言我来啦哈哈哈哈	喻言	0
牧尘宝贝啊别倔犟了	牧尘	1
胡小蝶是不是参加过舞蹈风暴里的那个？	舞蹈风暴	0
申洁没什么特色	申洁	-1
申冰但名字被换成了训练生	申冰	0
我要大声说我喜欢蔡卓宜	蔡卓宜	1